Beachfront
An Interactive Fiction
Release 1 / Serial number 210503 / Inform 7 build 6M62 (I6/v6.34 lib 6/12N) SD

Stuffy Office
The windows are closed, making the sultry air even more unbearable. A narrow slice of Caribbean blue is visible between the scuba gear rental shop and the recreated 17th century pirate tavern.

The office is cheerfully furnished with wicker chairs and white curtains, but the tropical decorating scheme stopped at the desk, which is heavy oak and absolutely covered with papers.

>x desk
You see nothing special about the heavy oak desk.

>x papers
You can't see any such thing.

>x paperwork
You see nothing special about the heavy oak desk.

>search desk
You rifle through the piles of bills and notices; invitations to conventions; advertisements for high-end prescription drugs; pink carbon sheets bearing patients' names and medical identification numbers in spidery, elderly handwriting. Almost at the bottom of the heap, you find what you were looking for: a creamy envelope with the address typed.

>search desk
On the heavy oak desk is a creamy envelope.

>x enveloppe
You can't see any such thing.

>x creamw enveloppe
You can't see any such thing.

>x creamy enveloppe
I only understood you as far as wanting to examine the creamy envelope.