Open Space
An Interactive Fiction by Thalie Schmidt, Laura Pippus, David Pavlik et Ludovic Rochat
Release 1 / Serial number 210510 / Inform 7 build 6M62 (I6/v6.34 lib 6/12N) SD

The office
Your boss and yourself are in the midst of stormy negotiations with new potential associates. The atmosphere is tense, so much so that you can feel sweat beads dripping down your tailored shirt as your sticky hands pound on your laptop keyboard. Your boss sits at your left while two other gentlemen sit straight across from you both. All of you have been in here, bargaining over contract terms, for quite a while now and you wrists are staring to ache as you write and erase what the others tell you to. The shadows you cast on the white office walls gently shift as the sun goes down,  you wish they had come up to an agreement by now.

Suddenly, either out of weariness or out of boldness, one of your guests leans in towards you and suggests a daring idea. You see a spark light up everybody else's as the idea sinks a little deeper in all of your minds.

-This is great ..! says your boss.

- This is illegal. you respond. Completely astonished by the nature of such suggestions.

- You're right, this can't appear on the records. Put that computer aside and grab a piece of paper! he adds.

You look around but can't seem to find any paper laying around. New ideas flood the room and you are not able the write any of them down. You painfully interrupt this flow of thoughts:

-Sir, I don't think we have any paper nor any pens. The bubbly brainstorm turns into three heavy stairs, the kind of stairs that strip you from your will to disagree.

- Would you be so kind as to go and fetch some for us ? asks the scarier of the two guest.

-Yes, of course. you respond as you quickly get up. 

You can see a big door, a Leather chair and a conference table here.

I beg your pardon?

>open bif door
You can't see any such thing.

>open big door
Mexico City
Gunshots pierce the sky as you cross the road of today's Mexico. It is getting quite dark and you don't want any trouble. You see four similarly unwellcoming alleyways each leading in different directions: south, north, east and west.

>go west
Aztec temple
The humming of a ritual chant bounces on the stone walls, you came right on time for the human sacrifice ! It seems like you landed in the past of Latin America and that the great Aztec civilization is at its peak.

A middle sized wall built in a strangely intelligent way with huge stones. It is too big for you to climb..

You can also see an Aztec Statue here.

>go south
Chinese Workshop
A small and dusty room, with a little window that opens to a wide rice field. The air is tick and gloomy due to the arrival of the rain season. An old artisan wearing a straw hat and loose hemp clothes made is making rice paper at the back of the room. You slowly approach the man and, after bending towards in sign of respect, you ask him:

- Sir, may I borrow one of these please?

- Yes, of course, go ahead.

>go south
Maharaja's palace
The imposing white marble palace is surrounded by the magnificent gardens of prince Abdul the second. Multiple fountains provide fresh water for the animals that reside in the gardens: birds of all colors and sizes that sing from dawn till dusk, little monkeys that jump from tree to tree and try to steal whatever you're eating, and beautiful colorful peacocks that turn around.

Looking one of the peacocks, you think to yourself: I bet I could use one of its feathers as a pen...

You can see a Peacock here.

>go south
Druid's tent
an old Celtic druid's tent, just like you imagined them. Drapy curtens frame passageways going north and south, they are too thick for you to see threw them. At the very back of the tent, behind all of the mess, you see a back door. Strangely enough, it looks like the one form your office 

The tent is cramped with peculiar shelves. They are made of thick lumber on which rests an army of glass jars filled with colorful liquids. Each jar is labeled with small srips of paper filled with a handwriting you can bearly decipher.

You can also see a small altar (on which are a rounded jar (closed), a skinny jar (closed) and pear shaped jar (closed)) and a cauldron here.

>take skinny jar
Taken.

>open skinny
You open the skinny jar, revealing an orange liquid.

>drink liquid
You feel ancestral powers fuzzing threw you.

 You now carry an empty jar.

>examine empty jar
You can't see any such thing.

* * *

I beg your pardon?

>open big door¨
I only understood you as far as wanting to open the big door.

>open big door
Scorpion World
Here you step into the future of Latin America. As time passed, a lot of species went extinct. Not scorpions though, scorpions got bigger. Unfortunately, way bigger than you. The whole contient mutated into a huge conurbation of enormous scorpion nests: you are in the middle of it. In front of you is one of those scorpion nest.

>go west
Mexico City
Gunshots pierce the sky as you cross the road of today's Mexico. It is getting quite dark and you don't want any trouble. You see four similarly unwellcoming alleyways each leading in different directions: south, north, east and west.

>go west
Aztec temple
The humming of a ritual chant bounces on the stone walls, you came right on time for the human sacrifice ! It seems like you landed in the past of Latin America and that the great Aztec civilization is at its peak.

A middle sized wall built in a strangely intelligent way with huge stones. It is too big for you to climb..

You can also see an Aztec Statue here.

* * *

>go south
Alexandria's Library
This is probably the greatest sanctuary of knowledge of all time. There are tons of books in there. They don't seem to be arranged in any specific order. You realize just how much looking up stuff was an elephantine task before the Internet.

You can see 100 books here.

>go south
Blizzard
Leave this place, you are in a primitive icy storm. The wind pierces your clothes and shut your eyes closed. You don't want to spend too much time in here. As you are reading this, your toes are getting frozen and threatens to fall. With your office clothes, you don't stand a chance. If you stay here few more seconds, you'll never see your beloved office again.

>take skinny jar
You can't see any such thing.

>read the label
What do you want to read the label of?

>open skinny
You can't see any such thing.

>drink orange liquid
You can't see any such thing.

* * *

>open big door
Wuhan
A new, deadly virus was detected for the first time here. The city center is deserted, while the hospitals and morgues are filled with covid patients. You don't have a mask, you not even have a scarf to put around your mouth and nose... it might be better to leave Wuhan as fast as possible!!

>north
Mexico City
Gunshots pierce the sky as you cross the road of today's Mexico. It is getting quite dark and you don't want any trouble. You see four similarly unwellcoming alleyways each leading in different directions: south, north, east and west.

>east
Scorpion World
Here you step into the future of Latin America. As time past, a lot of species went extinct. Not scorpions though, scorpions got bigger. Unfortunately, way bigger than you. The whole contient mutated into a huge conurbation of enormous scorpion nests: you are in the middle of it. In front of you is one of those scorpion nest.

The nest is swarming with "little" scorpions, as big as your head. Inside your head precisely, alongside your fear, your pragmatic common sense tells you something like "don't you think that this baby scorpion's tail could do a marvellous pen?"

>x nest
In the nest is a baby scorpion.

>attack scorpion
You find nothing of interest.

* * *

>$
That's not a verb I recognise.

>look around
You can't see any such thing.

>examine office
You can't see any such thing.

>open big door
Chinese Workshop
A small and dusty room, with a little window that opens to a wide rice field. The air is tick and gloomy due to the arrival of the rain season. An old artisan wearing a straw hat and loose hemp clothes made is making rice paper at the back of the room. You slowly approach the man and, after bending towards in sign of respect, you ask him:

- Sir, may I borrow one of these please?

- Yes, of course, go ahead.

>go south
Maharaja's palace
The imposing white marble palace is surrounded by the magnificent gardens of prince Abdul the second. Multiple fountains provide fresh water for the animals that reside in the gardens: birds of all colors and sizes that sing from dawn till dusk, little monkeys that jump from tree to tree and try to steal whatever you're eating, and beautiful colorful peacocks that turn around.

Looking one of the peacocks, you think to yourself: I bet I could use one of its feathers as a pen...

You can see a Peacock here.

* * *

>go to back door
You can't see any such thing.

>go south
Savannah
Savannah today

>go south
Scientific base camp
The only thing you see beyond the camp's igloos is ice and extracted ice caps. You don't want to spend too much time here unless you always wanted to be a human ice cream. The igloos are scattered over a large area, but one is not far away. If you want to go inside, you'll have to crawl through the entrance tunnel.

You can see an entrance tunnel here.

>go down
Igloo
You cannot see much, but on your right is a sleeping scientist.

You can see an entrance tunnel here.

>up
Scientific base camp
The only thing you see beyond the camp's igloos is ice and extracted ice caps. You don't want to spend too much time here unless you always wanted to be a human ice cream. The igloos are scattered over a large area, but one is not far away. If you want to go inside, you'll have to crawl through the entrance tunnel.

You can see an entrance tunnel here.

>up
You can't go that way.

>down
Igloo
You cannot see much, but on your right is a sleeping scientist.

You can see an entrance tunnel here.

>x sleeping scientist
You can't see any such thing.

* * *

>look big door
it is your only way out of the room. Something tells you you should be quick to open it and get on that paper and pen hunt of yours.

I beg your pardon?

>open big oor
I only understood you as far as wanting to open the big door.

>open big door
Scientific Base Camp
The only thing you see beyond the camp's igloos is ice and extracted ice caps. You don't want to spend too much time here unless you always wanted to be a human ice cream. The igloos are scattered over a large area, but one is not far away. If you want to go inside, you'll have to crawl through the entrance tunnel.

You can see an entrance tunnel here.

* * *

>look starting
You can't see any such thing.

>look office
You can't see any such thing.

>look table
This table is unnecessary large for the number of people it is currently hosting. Since it is made out of glass, you can still perfectly see the traces your sweaty fingers laid of it earlier.

>look chair
Very fashionnable, although you find it a bit rigid. Maybe it's because you sat on it for too long.

>open
What do you want to open?

>door
Aztec temple
The humming of a ritual chant bounces on the stone walls, you came right on time for the human sacrifice ! It seems like you landed in the past of Latin America and that the great Aztec civilization is at its peak.

A middle sized wall built in a strangely intelligent way with huge stones. It is too big for you to climb..

You can also see an Aztec Statue here.

* * *

>look table
This table is unnecessary large for the number of people it is currently hosting. Since it is made out of glass, you can still perfectly see the traces your sweaty fingers laid of it earlier.

>open door
Which do you mean, the shiny door, the outstanding door, the back door, the familiar looking door or the big door?

* * *

>open big door
Aztec temple
The humming of a ritual chant bounces on the stone walls, you came right on time for the human sacrifice ! It seems like you landed in the past of Latin America and that the great Aztec civilization is at its peak.

A middle sized wall built in a strangely intelligent way with huge stones. It is too big for you to climb..

You can also see an Aztec Statue here.

Wait a minute, how did you end up here?  

 Well well, the dimesions heard you and sent you quite far away. You just entered a time and space traveling journey taking a strall to the east fast forwards you to the futur, the west brings you back to the past. As for north and south, they change your current geographical location.  

One has to be careful of what he wishes for nowadays... you better find your way back to your meeting, fast, and with the correct supplies.

>crawl
What do you want to crawl in?

>up
Scientific Base Camp
Present of Antarctica. The only thing you see beyond the camp's igloos is ice and extracted ice caps. You don't want to spend too much time here unless you always wanted to be a human ice cream. The igloos are scattered over a large area, but one is not far away. If you want to go inside, you'll have to crawl through the entrance tunnel.

You can see an entrance tunnel here.

>crawl
(in the entrance tunnel)

Igloo
You cannot see much, but a dying fire sufficiently illuminates the place to be able to see the room made of ice. At the back of the igloo, you see a sleeping person. He looks like a researcher, he certainly writes things down everyday...

You can see an entrance tunnel and a sleeping researcher here.

* * *

>east
Mexico City
Gunshots pierce the sky as you cross the road of today's Mexico. It is getting quite dark and you don't want any trouble. You see four similarly unwellcoming alleyways each leading in different directions: south, north, east and west.

>east
Scorpion World
Here you step into the future of Latin America. As time past, a lot of species went extinct. Not scorpions though, scorpions got bigger. Unfortunately, way bigger than you. The whole contient mutated into a huge conurbation of enormous scorpion nests: you are in the middle of it. In front of you is one of those scorpion nest.

The nest is swarming with "little" scorpions, as big as your head. Inside your head precisely, alongside your fear, your pragmatic common sense tells you something like "don't you think that this baby scorpion's tail could do a marvellous pen?"

* * *

>x nest
In the nest is a baby scorpion.

>north
You can't go that way.

>west
Mexico City
Gunshots pierce the sky as you cross the road of today's Mexico. It is getting quite dark and you don't want any trouble. You see four similarly unwellcoming alleyways each leading in different directions: south, north, east and west.

>north
Scientific Base Camp
Present of Antarctica. The only thing you see beyond the camp's igloos is ice and extracted ice caps. You don't want to spend too much time here unless you always wanted to be a human ice cream. The igloos are scattered over a large area, but one is not far away. If you want to go inside, you'll have to crawl through the tunnel.

You can see a tunnel here.

>crawl
(in the tunnel)

Igloo
You cannot see much, but a dying fire sufficiently illuminates the place to be able to see the room made of ice. At the back of the igloo, you see a sleeping person. He looks like a researcher, he certainly writes things down everyday...

You can see a tunnel and a sleeping researcher here.

>search researcher
You lift the multiple layers of blankets and fur and after a quick search you see something shiny that catches your frozen eyes: a Mont Blanc quill! Exactly what your boss needs to sign the contract. After a brief discussion with your conscience, you decide to take it.

* * *

>east
Mexico City
Gunshots pierce the sky as you cross the road of today's Mexico. It is getting quite dark and you don't want any trouble. You see four similarly unwellcoming alleyways each leading in different directions: south, north, east and west.

>south
Scientific Base Camp
Present of Antarctica. The only thing you see beyond the camp's igloos is ice and extracted ice caps. You don't want to spend too much time here unless you always wanted to be a human ice cream. The igloos are scattered over a large area, but one is not far away. If you want to go inside, you'll have to crawl through the entrance tunnel.

You can see an entrance tunnel here.

>south
Mexico City
Gunshots pierce the sky as you cross the road of today's Mexico. It is getting quite dark and you don't want any trouble. You see four similarly unwellcoming alleyways each leading in different directions: south, north, east and west.

>east
Scorpion World
Here you step into the future of Latin America. As time past, a lot of species went extinct. Not scorpions though, scorpions got bigger. Unfortunately, way bigger than you. The whole contient mutated into a huge nest of enormous scorpions: you are in the middle of it.

The nest is swarming with "little" scorpions. In your head, alongside your fear, your pragmatic common sense tells you something like "don't you think that this baby scorpion's could do a marvellous pen?"

* * *

>east
Mexico City
Gunshots pierce the sky as you cross the road of today's Mexico. It is getting quite dark and you don't want any trouble. You see four similarly unwellcoming alleyways each leading in different directions: south, north, east and west.

>x nest
The nest is empty.

* * *

>futur
You can't go that way.

>pas
That's not a verb I recognise.

>pasr
That's not a verb I recognise.

>past
New Delhi
You are now in the city center of New Dehli nowadays: your senses are flooded with all kinds of informations. The smells of a thousand spices assault your nostrils from a street market on your right hand and their colors fill up your soul like flowers in the spring, birds are singing and market sellers seems to be answering them prices of their marchandises; the whole thing is wrapped up in a whirlwind of scooters and tuktuk, adding a deeply human touch to the frenzy of the moment.

Somewhere in this exotic atmosphere, your eye catches a strange thing that doesn't seem to belong here: a modern glass door. You know, that opaque kind of glass which looks very expensive. Of course you'd know, your office has the same ones.

>north
Wuhan
A new, deadly virus was detected for the first time here. The city center is deserted, while the hospitals and morgues are filled with covid patients. You don't have a mask, you not even have a scarf to put around your mouth and nose... it might be better to leave Wuhan as fast as possible!!

>north
Mexico City
Gunshots pierce the sky as you cross the road of today's Mexico. It is getting quite dark and you don't want any trouble. You see four similarly unwellcoming alleyways each leading in different directions: south, north, east and west.

>north
Scientific Base Camp
Present of Antarctica. The only thing you see beyond the camp's igloos is ice and extracted ice caps. You don't want to spend too much time here unless you always wanted to be a human ice cream. The igloos are scattered over a large area, but one is not far away. If you want to go inside, you'll have to crawl through the tunnel.

You can see a tunnel here.

>futur
Utopian City
Cars finally float on air cushions and plants co-exist with skyscrapers in a friendly and aesthetic way. 

A flying car is floating in front of you.

>x car
The flying car goes up and down in a very fluide way. It is completely made of glass and its shape is oval and sleek.

In the floating car is an universal magnetic pass.

>go in car
You get into the floating car.

In the floating car you can see an universal magnetic pass.

>take pass
The moment you touch the magnectic pass, the car elevates and you are instantly 1000 feets above the ground. Seconds that follows reminds you of that one time in a theme park where you wanted to show off in front of the girl you were seeing, and you finished puking exactly on her head from 20 feet high. This time, the cars flies at what seems to be a very high speed, but you don't feel anything. After few seconds, it lands at the exact same place you found it. You carfully take the pass, taking care not to press on it.

>i
You are carrying:
  an universal magnetic pass

>get off car
But you aren't on the floating car at the moment.

* * *

>go left
You can't see any such thing.

* * *

>go north
Savannah
Savannah today

A big and modern glass door. You know, that opaque kind of glass which looks very expensive.

>go west
Alexandria's Library
This is probably the greatest sanctuary of knowledge of all time. There are tons of books in there. They don't seem to be arranged in any specific order. You realize just how much looking up stuff was an elephantine task before the Internet.

You can see 100 books here.

>go east
Savannah
Savannah today

A big and modern glass door. You know, that opaque kind of glass which looks very expensive.

* * *

>go east
Souk Ruins
A labyrinthine series of corridors unfolds in front of you. The stones that pave the ground reflect the dazzling sunlight

You can see a Chest (closed) here.

>go north
Swamps
The air here is breezy. It is hard for you to move comfortably because your feet are plunged in water, or is it silt ? Vegetation is quite dense, reeds and weeds pave your way. If you look west, you can see the framework of a door in the distance. Strangely enough, it looks like the one form your office. There are poorly lit openings in the trees leading either to the north or the south. 

A big and modern glass door. You know, that opaque kind of glass which looks very expensive.

You can also see an Aligator (on which is a scaly skin) and a long wooden stick here.

>open door
It seems to be locked.

>unlock door
What do you want to unlock the familiar looking door with?

>pass
You can't see any such thing.

* * *

>go south
You can't go that way.

>look skinny
You can't see any such thing.

>open skinny
You can't see any such thing.

>drink liquid
You can't see any such thing.

>look skinny
You can't see any such thing.

>go west
You can't go that way.

>go west
You can't go that way.

>go south
You can't go that way.

>go south
You can't go that way.

* * *

>open skinny
You can't see any such thing.

>drink skinny
You can't see any such thing.

>drink liquid
You can't see any such thing.

* * *

>go west
You can't go that way.

>go south
Maharaja's palace
The imposing white marble palace is surrounded by the magnificent gardens of prince Abdul the second. Multiple fountains provide fresh water for the animals that reside in the gardens: birds of all colors and sizes that sing from dawn till dusk, little monkeys that jump from tree to tree and try to steal whatever you're eating, and beautiful colorful peacocks that turn around.

Looking one of the peacocks, you think to yourself: I bet I could use one of its feathers as a pen...

You can see a Peacock here.

* * *

>go south
Alexandria's Library
This is probably the greatest sanctuary of knowledge of all time. There are tons of books in there. They don't seem to be arranged in any specific order. You realize just how much looking up stuff was an elephantine task before the Internet.

You can see 100 books here.

>take skinny jat
You can't see any such thing.

>take the skinny jar
You can't see any such thing.

>read
(100 books)
(first taking 100 books)
You can only read labels.

>open
(100 books)
It isn't something you can open.

>drink
(100 books)
There's nothing suitable to drink here.

>drink the orange liquid
You can't see any such thing.

>open bak door
You can't see any such thing.

>open back door
You can't see any such thing.

>go west
You can't go that way.

>go south
Blizzard
Leave this place, you are in a primitive icy storm. The wind pierces your clothes and shut your eyes closed. You don't want to spend too much time in here. As you are reading this, your toes are getting frozen and threatens to fall. With your office clothes, you don't stand a chance. If you stay here few more seconds, you'll never see your beloved office again.

>go south
Aztec temple
The humming of a ritual chant bounces on the stone walls, you came right on time for the human sacrifice ! It seems like you landed in the past of Latin America and that the great Aztec civilization is at its peak.

A middle sized wall built in a strangely intelligent way with huge stones. It is too big for you to climb..

You can also see an Aztec Statue here.

I beg your pardon?

I beg your pardon?

>go south
Chinese Workshop
A small and dusty room, with a little window that opens to a wide rice field. The air is tick and gloomy due to the arrival of the rain season. An old artisan wearing a straw hat and loose hemp clothes made is making rice paper at the back of the room. You slowly approach the man and, after bending towards in sign of respect, you ask him:

- Sir, may I borrow one of these please?

- Yes, of course, go ahead.

* * *

>go south
Alexandria's Library
This is probably the greatest sanctuary of knowledge of all time. There are tons of books in there. They don't seem to be arranged in any specific order. You realize just how much looking up stuff was an elephantine task before the Internet.

>go south
Blizzard
Leave this place, you are in a primitive icy storm. The wind pierces your clothes and shut your eyes closed. You don't want to spend too much time in here. As you are reading this, your toes are getting frozen and threatens to fall. With your office clothes, you don't stand a chance. If you stay here few more seconds, you'll never see your beloved office again.

* * *

>take skinny jar
You can't see any such thing.

>open
(100 books)
It isn't something you can open.

>drink liquid
You can't see any such thing.

>open back door
You can't see any such thing.

* * *

>go south
Maharaja's palace
The imposing white marble palace is surrounded by the magnificent gardens of prince Abdul the second. Multiple fountains provide fresh water for the animals that reside in the gardens: birds of all colors and sizes that sing from dawn till dusk, little monkeys that jump from tree to tree and try to steal whatever you're eating, and beautiful colorful peacocks that turn around.

Looking one of the peacocks, you think to yourself: I bet I could use one of its feathers as a pen...

You can see a Peacock here.

>go up
You can't go that way.

>go down
You can't go that way.

>go south
Aztec temple
The humming of a ritual chant bounces on the stone walls, you came right on time for the human sacrifice ! It seems like you landed in the past of Latin America and that the great Aztec civilization is at its peak.

A middle sized wall built in a strangely intelligent way with huge stones. It is too big for you to climb..

You can also see an Aztec Statue here.

>go south
Chinese Workshop
A small and dusty room, with a little window that opens to a wide rice field. The air is tick and gloomy due to the arrival of the rain season. An old artisan wearing a straw hat and loose hemp clothes made is making rice paper at the back of the room. You slowly approach the man and, after bending towards in sign of respect, you ask him:

- Sir, may I borrow one of these please?

- Yes, of course, go ahead.

* * *

>go south
Maharaja's palace
The imposing white marble palace is surrounded by the magnificent gardens of prince Abdul the second. Multiple fountains provide fresh water for the animals that reside in the gardens: birds of all colors and sizes that sing from dawn till dusk, little monkeys that jump from tree to tree and try to steal whatever you're eating, and beautiful colorful peacocks that turn around.

Looking one of the peacocks, you think to yourself: I bet I could use one of its feathers as a pen...

You can see a Peacock here.

>take sinny jar
You can't see any such thing.

>open skinny jar
You can't see any such thing.

>drink skinny jar
You can't see any such thing.

>drink liquid
You can't see any such thing.

>look skinny jar
You can't see any such thing.

>go north
Chinese Workshop
A small and dusty room, with a little window that opens to a wide rice field. The air is tick and gloomy due to the arrival of the rain season. An old artisan wearing a straw hat and loose hemp clothes made is making rice paper at the back of the room. You slowly approach the man and, after bending towards in sign of respect, you ask him:

- Sir, may I borrow one of these please?

- Yes, of course, go ahead.

>go north
Aztec temple
The humming of a ritual chant bounces on the stone walls, you came right on time for the human sacrifice ! It seems like you landed in the past of Latin America and that the great Aztec civilization is at its peak.

A middle sized wall built in a strangely intelligent way with huge stones. It is too big for you to climb..

You can also see an Aztec Statue here.

>take skinny
You can't see any such thing.

>read skinny
You can't see any such thing.

>look skinny
You can't see any such thing.

* * *

>go south
You can't go that way.

>go south
(first opening the shiny door)
It seems to be locked.

>look skinny jar
You can't see any such thing.

>take skinny
You can't see any such thing.

>open skinny
You can't see any such thing.

* * *

>drink skinny
You can't see any such thing.

>look skinny
You can't see any such thing.

* * *

>go south
You can't go that way.

>take rounded jar¨
You can't see any such thing.

>take rounded jar
You can't see any such thing.

>read
What do you want to read?

>open
What do you want to open?

>drink blue
You can't see any such thing.

>take pear
You can't see any such thing.

>read
What do you want to read?

>read pear shaped¨
You can't see any such thing.

>read pear shaped
You can't see any such thing.

>open
What do you want to open?

>open pear
You can't see any such thing.

>drink
What do you want to drink?

>drink pink liquuid
You can't see any such thing.

>drink pink liquid
You can't see any such thing.

* * *

>north
(first opening the shiny door)
It seems to be locked.

>east
New Delhi
The city center today

A big and modern glass door. You know, that opaque kind of glass which looks very expensive. Of course you'd know, your office has the same ones.

>north
Wuhan
A new, deadly virus was detected for the first time here. The city center is deserted, while the hospitals and morgues are filled with covid patients. You don't have a mask, you not even have a scarf to put around your mouth and nose... it might be better to leave Wuhan as fast as possible!!

* * *

>x nest
In the nest is a baby scorpion.

>attack baby
skirt

>i
You are carrying:
  a scorpion's tail

* * *

>east
New Delhi
The city center today

A big and modern glass door. You know, that opaque kind of glass which looks very expensive. Of course you'd know, your office has the same ones.

>west
New Delhi
The city center today

A big and modern glass door. You know, that opaque kind of glass which looks very expensive. Of course you'd know, your office has the same ones.

>north
Wuhan
A new, deadly virus was detected for the first time here. The city center is deserted, while the hospitals and morgues are filled with covid patients. You don't have a mask, you not even have a scarf to put around your mouth and nose... it might be better to leave Wuhan as fast as possible!!

* * *

>north
Mexico City
Gunshots pierce the sky as you cross the road of today's Mexico. It is getting quite dark and you don't want any trouble. You see four similarly unwellcoming alleyways each leading in different directions: south, north, east and west.

>east
Scorpion World
Here you step into the future of Latin America. As time past, a lot of species went extinct. Not scorpions though, scorpions got bigger. Unfortunately, way bigger than you. The whole contient mutated into a huge nest of enormous scorpions: you are in the middle of it.

>x
What do you want to examine?

>x nest
You can't see any such thing.

* * *

>north
(first opening the shiny door)
It seems to be locked.

>north
Maharaja's palace
The imposing white marble palace is surrounded by the magnificent gardens of prince Abdul the second. Multiple fountains provide fresh water for the animals that reside in the gardens: birds of all colors and sizes that sing from dawn till dusk, little monkeys that jump from tree to tree and try to steal whatever you're eating, and beautiful colorful peacocks that turn around.

Looking one of the peacocks, you think to yourself: I bet I could use one of its feathers as a pen...

You can see a Peacock here.

>east
New Delhi
You are now in the city center of New Dehli nowadays: your senses are flooded with all kinds of informations. The smells of a thousand spices assault your nostrils from a street market on your right hand and their colors fill up your soul like flowers in the spring, birds are singing and market sellers seems to be answering them prices of their marchandises, the whole thing is wrapped up in a whirlwind of scooters and tuktuk that add a deeply human touch to the frenzy of the moment.

Somewhere in this exotic atmosphere, your eye catches a strange thing that doesn't seem to belong here: a modern glass door. You know, that opaque kind of glass which looks very expensive. Of course you'd know, your office has the same ones.

>open door
It seems to be locked.

* * *

>x nest
In the nest is a baby scorpion.

>fight the baby
Violence isn't the answer to this one.

* * *

>north
(first opening the shiny door)
It seems to be locked.

>south
Scientific Base Camp
Present of Antarctica. The only thing you see beyond the camp's igloos is ice and extracted ice caps. You don't want to spend too much time here unless you always wanted to be a human ice cream. The igloos are scattered over a large area, but one is not far away. If you want to go inside, you'll have to crawl through the tunnel.

You can see a tunnel here.

>south
Mexico City
Gunshots pierce the sky as you cross the road of today's Mexico. It is getting quite dark and you don't want any trouble. You see four similarly unwellcoming alleyways each leading in different directions: south, north, east and west.

>futur
Scorpion World
Here you step into the future of Latin America. As time passed, a lot of species went extinct. Not scorpions though, scorpions got bigger. Unfortunately, way bigger than you. The whole contient mutated into a huge conurbation of enormous scorpion nests: you are in the middle of it. In front of you is one of those scorpion nest.

The nest is swarming with "little" scorpions, as big as your head. One of the baby scorpion - that you surprisingly find cute with its sharp little claws, its hairy exoskeleton and its menacing scorpion's tail dancing gently in the warm wind - comes to you, certainly interested by your delicious monkey shape. Violence is never an answer - but now that you are in front of the scorpion that keeps coming closer, saliva dripping from its lips, I would suggest you to attack it!"

>past
Mexico City
Gunshots pierce the sky as you cross the road of today's Mexico. It is getting quite dark and you don't want any trouble. You see four similarly unwellcoming alleyways each leading in different directions: south, north, east and west.

>past
Aztec Temple
The humming of a ritual chant bounces on the stone walls, you came right on time for the human sacrifice ! It seems like you landed in the past of Latin America and that the great Aztec civilization is at its peak.

A middle sized wall built in a strangely intelligent way with huge stones. It is too big for you to climb..

You can also see an Aztec Statue here.

>get on statue
That's not something you can enter.

>climb wall
Don't even try, you are ridiculously small in front of this wall.

* * *

>open big door
Scientific Base Camp
Present of Antarctica. The only thing you see beyond the camp's igloos is ice and extracted ice caps. You don't want to spend too much time here unless you always wanted to be a human ice cream. The igloos are scattered over a large area, but one is not far away. If you want to go inside, you'll have to crawl through the tunnel.

You can see a tunnel here.

>south
Mexico City
Gunshots pierce the sky as you cross the road of today's Mexico. It is getting quite dark and you don't want any trouble. You see four similarly unwellcoming alleyways each leading in different directions: south, north, east and west.

>east
Scorpion World
Here you step into the future of Latin America. As time passed, a lot of species went extinct. Not scorpions though, scorpions got bigger. Unfortunately, way bigger than you. The whole contient mutated into a huge conurbation of enormous scorpion nests: you are in the middle of it. In front of you is one of those scorpion nest.

The nest is swarming with "little" scorpions, as big as your head. One of the baby scorpion - that you surprisingly find cute with its sharp little claws, its hairy exoskeleton and its menacing scorpion's tail dancing gently in the warm wind - comes to you, certainly interested by your delicious monkey shape. Violence is never an answer - but now that you are in front of the scorpion that keeps coming closer, saliva dripping from its lips, I would suggest you to attack it!"

>attack
(the nest)
Violence isn't the answer to this one.

>attck the baby
That's not a verb I recognise.

>attack the baby
After an epic battle in which you found yourself without trousers because your belt was the only weapon you could find, you finally manage to finish off the baby scorpion that passes away looking you right in the eyes. To honor this proud and mighty enemy, you decide to craft a pen out of it's tail.

* * *

>past
Wuhan
A new, deadly virus was detected for the first time here. The city center is deserted, while the hospitals and morgues are filled with covid patients. You don't have a mask, you not even have a scarf to put around your mouth and nose... it might be better to leave Wuhan as fast as possible!!

>east
Yogi's retreat
The only community still standing in 20900"s India. This sanctuary is filled with trees, and in the network of streams that run around, you can see huge red, orange and white carps. Yoga matresses are pretty much everywhere, and the smell of the incense is just delightful. You feel a big sense of inner peace... if you stay too long here, you might never leave.

You can see a black jack here.

* * *

>past
Wuhan
A new, deadly virus was detected for the first time here. The city center is deserted, while the hospitals and morgues are filled with covid patients. You don't have a mask, you not even have a scarf to put around your mouth and nose... it might be better to leave Wuhan as fast as possible!!

>north
Mexico City
Gunshots pierce the sky as you cross the road of today's Mexico. It is getting quite dark and you don't want any trouble. You see four similarly unwellcoming alleyways each leading in different directions: south, north, east and west.

>past
Aztec Temple
The humming of a ritual chant bounces on the stone walls, you came right on time for the human sacrifice ! It seems like you landed in the past of Latin America and that the great Aztec civilization is at its peak.

A middle sized wall built in a strangely intelligent way with huge stones. It is too big for you to climb..

You can also see an Aztec Statue here.

>get on statue
You get onto the Aztec Statue.

>climb wall
(first getting off the Aztec Statue)
As you are not an athlete, this operation is proving very difficult; but you manage to pull yourself up.

Ritual Waste
This place reminds you why you dont like BBQ: mostly because of the smell... While you are wondering why you got up here, your eyes are caught by what seems to be a human collarbone. It is strangely sharp, it almost look like a pen..

You can see a sharp collarbone here.

>take collarbone
Taken.

>i
You are carrying:
  a sharp collarbone

* * *

>past
Aztec Temple
The humming of a ritual chant bounces on the stone walls, you came right on time for the human sacrifice ! It seems like you landed in the past of Latin America and that the great Aztec civilization is at its peak.

A middle sized wall built in a strangely intelligent way with huge stones. It is too big for you to climb..

You can also see an Aztec Statue here.

>x statue
A representation of Quetzalcóatl, the snake-god. It is cubical and stable. It stands just in front of a wall, behind which is a strange place that looks like a landfill site but instead of broken washing machines and old lamps, a lot of yellow-white sticks and balls with wholes are laying there...

>get on the statue
That's not something you can enter.

>get on statue
That's not something you can enter.

>climb up
Don't even try, you are ridiculously small in front of this wall.

* * *

>past
Wuhan
A new, deadly virus was detected for the first time here. The city center is deserted, while the hospitals and morgues are filled with covid patients. You don't have a mask, you not even have a scarf to put around your mouth and nose... it might be better to leave Wuhan as fast as possible!!

>past
Aztec Temple
The humming of a ritual chant bounces on the stone walls, you came right on time for the human sacrifice ! It seems like you landed in the past of Latin America and that the great Aztec civilization is at its peak.

A middle sized wall built in a strangely intelligent way with huge stones. It is too big for you to climb..

You can also see an Aztec Statue here.

* * *

>get on statue
You get onto the Aztec Statue.

>climb wall
(first getting off the Aztec Statue)

Ritual Waste
This place reminds you why you dont like BBQ: mostly because of the smell... While you are wondering why you got up here, your eyes are caught by what seems to be a human collarbone. It is strangely sharp, it almost look like a pen..

* * *

>south
Swamps
The air here is breezy. It is hard for you to move comfortably because your feet are plunged in water, or is it silt ? Vegetation is quite dense, reeds and weeds pave your way. If you look west, you can see the framework of a door in the distance. Strangely enough, it looks like the one form your office. There are poorly lit openings in the trees leading either to the north or the south. 

A big and modern glass door. You know, that opaque kind of glass which looks very expensive.

You can also see an Aligator (on which is a scaly skin) and a long wooden stick here.

>east
Savannah
Savannah today

A big and modern glass door. You know, that opaque kind of glass which looks very expensive.

>south
Scientific Base Camp
Present of Antarctica. The only thing you see beyond the camp's igloos is ice and extracted ice caps. You don't want to spend too much time here unless you always wanted to be a human ice cream. The igloos are scattered over a large area, but one is not far away. If you want to go inside, you'll have to crawl through the tunnel.

You can see a tunnel here.

* * *

>attack
(the nest)
After an epic battle in which you found yourself without trousers because your belt was the only weapon you could find, you finally manage to finish off the baby scorpion that passes away looking you right in the eyes. To honor this proud and mighty enemy, you decide to craft a pen out of it's tail.

* * *

>east
Savannah
Savannah today

A big and modern glass door. You know, that opaque kind of glass which looks very expensive.

>x nest
In the nest is a scorpion's tail.

* * *

>south
Swamps
The air here is breezy. It is hard for you to move comfortably because your feet are plunged in water, or is it silt ? Vegetation is quite dense, reeds and weeds pave your way. If you look west, you can see the framework of a door in the distance. Strangely enough, it looks like the one form your office. There are poorly lit openings in the trees leading either to the north or the south. 

A big and modern glass door. You know, that opaque kind of glass which looks very expensive.

You can also see an Aligator (on which is a scaly skin) and a long wooden stick here.

>north
Wuhan
A new, deadly virus was detected for the first time here. The city center is deserted, while the hospitals and morgues are filled with covid patients. You don't have a mask, you not even have a scarf to put around your mouth and nose... it might be better to leave Wuhan as fast as possible!!

* * *

>north
Mexico City
Gunshots pierce the sky as you cross the road of today's Mexico. It is getting quite dark and you don't want any trouble. You see four similarly unwellcoming alleyways each leading in different directions: south, north, east and west.

>east
Scorpion World
Here you step into the future of Latin America. As time passed, a lot of species went extinct. Not scorpions though, scorpions got bigger. Unfortunately, way bigger than you. The whole contient mutated into a huge conurbation of enormous scorpion nests: you are in the middle of it. In front of you is one of those scorpion nest.

The nest is swarming with "little" scorpions, as big as your head. One of the baby scorpion - that you surprisingly find cute with its sharp little claws, its hairy exoskeleton and its menacing scorpion's tail dancing gently in the warm wind - comes to you, certainly interested by your delicious monkey shape. Violence is never an answer - but now that you are in front of the scorpion that keeps coming closer, saliva dripping from its lips, I would suggest you to attack it!"

>west
Mexico City
Gunshots pierce the sky as you cross the road of today's Mexico. It is getting quite dark and you don't want any trouble. You see four similarly unwellcoming alleyways each leading in different directions: south, north, east and west.

>west
Aztec Temple
The humming of a ritual chant bounces on the stone walls, you came right on time for the human sacrifice ! It seems like you landed in the past of Latin America and that the great Aztec civilization is at its peak.

You can see an Astec Statue here.

>x statue
A representation of Quetzalcóatl, the snake-god. It is cubical and stable. It is just in front a strange place that looks like a landfill site but instead of broken washing machines and old lamps, a lot of yellow-white sticks and balls with wholes...

* * *

>north
Mexico City
Gunshots pierce the sky as you cross the road of today's Mexico. It is getting quite dark and you don't want any trouble. You see four similarly unwellcoming alleyways each leading in different directions: south, north, east and west.

>north
You can't go that way.

>east
New Delhi
You are now in the city center of New Dehli nowadays: your senses are flooded with all kinds of informations. The smells of a thousand spices assault your nostrils from a street market on your right hand and their colors fill up your soul like flowers in the spring, birds are singing and market sellers seems to be answering them prices of their marchandises, the whole thing is wrapped up in a whirlwind of scooters and tuktuk that add a deeply human touch to the frenzy of the moment.

Somewhere in this exotic atmosphere, your eye catches a strange thing that doesn't seem to belong here: a modern glass door. You know, that opaque kind of glass which looks very expensive. Of course you'd know, your office has the same ones.

>north
Wuhan
A new, deadly virus was detected for the first time here. The city center is deserted, while the hospitals and morgues are filled with covid patients. You don't have a mask, you not even have a scarf to put around your mouth and nose... it might be better to leave Wuhan as fast as possible!!

* * *

>north
Mexico City
Gunshots pierce the sky as you cross the road of today's Mexico. It is getting quite dark and you don't want any trouble. You see four similarly unwellcoming alleyways each leading in different directions: south, north, east and west.

>nortjh
That's not a verb I recognise.

I beg your pardon?

>north
Scientific Base Camp
Present of Antarctica. The only thing you see beyond the camp's igloos is ice and extracted ice caps. You don't want to spend too much time here unless you always wanted to be a human ice cream. The igloos are scattered over a large area, but one is not far away. If you want to go inside, you'll have to crawl through the tunnel.

You can see a tunnel here.

* * *

>crawl
(in the tunnel)

Igloo
You cannot see much, but a dying fire sufficiently illuminates the place to be able to see the room made of ice. At the back of the igloo, you see a sleeping person. He looks like a researcher, he certainly writes things down everyday...

You can see a tunnel and a sleeping researcher here.

>x researcher
This sleeping guy has papers and tools around him. It looks like he is a researcher. He sleeps like a log.

>search researcher
You lift the multiple layers of blankets and fur and after a quick search you see something shiny that catches your frozen eyes: a Mont Blanc quill! Exactly what your boss needs to sign the contract. After a brief discussion with your conscience, you decide to take it.

>i
You are carrying:
  a Mont Blanc quill

>crawl
(in the Mont Blanc quill)
You can't go that way.

>crawl into the tunnel
Scientific Base Camp
Present of Antarctica. The only thing you see beyond the camp's igloos is ice and extracted ice caps. You don't want to spend too much time here unless you always wanted to be a human ice cream. The igloos are scattered over a large area, but one is not far away. If you want to go inside, you'll have to crawl through the tunnel.

You can see a tunnel here.

>north
Savannah
Savannah today

A big and modern glass door. You know, that opaque kind of glass which looks very expensive.

>south
Scientific Base Camp
Present of Antarctica. The only thing you see beyond the camp's igloos is ice and extracted ice caps. You don't want to spend too much time here unless you always wanted to be a human ice cream. The igloos are scattered over a large area, but one is not far away. If you want to go inside, you'll have to crawl through the tunnel.

You can see a tunnel here.

* * *

>south
Mexico City
Gunshots pierce the sky as you cross the road of today's Mexico. It is getting quite dark and you don't want any trouble. You see four similarly unwellcoming alleyways each leading in different directions: south, north, east and west.

>south
Wuhan
A new, deadly virus was detected for the first time here. The city center is deserted, while the hospitals and morgues are filled with covid patients. You don't have a mask, you not even have a scarf to put around your mouth and nose... it might be better to leave Wuhan as fast as possible!!

>south
New Delhi
You are now in the city center of New Dehli nowadays: your senses are flooded with all kinds of informations. The smells of a thousand spices assault your nostrils from a street market on your right hand and their colors fill up your soul like flowers in the spring, birds are singing and market sellers seems to be answering them prices of their marchandises, the whole thing is wrapped up in a whirlwind of scooters and tuktuk that add a deeply human touch to the frenzy of the moment.

Somewhere in this exotic atmosphere, your eye catches a strange thing that doesn't seem to belong here: a modern glass door. You know, that opaque kind of glass which looks very expensive. Of course you'd know, your office has the same ones.

>x door
You see nothing special about the returning door.

>open door
It seems to be locked.

* * *

>south
Swamps
The air here is breezy. It is hard for you to move comfortably because your feet are plunged in water, or is it silt ? Vegetation is quite dense, reeds and weeds pave your way. If you look west, you can see the framework of a door in the distance. Strangely enough, it looks like the one form your office. There are poorly lit openings in the trees leading either to the north or the south. 

A big and modern glass door. You know, that opaque kind of glass which looks very expensive.

You can also see an Aligator (on which is a scaly skin) and a long wooden stick here.

>south
Souk Ruins
A labyrinthine series of corridors unfolds in front of you. The stones that pave the ground reflect the dazzling sunlight

You can see a Chest (closed) here.

>east
You can't go that way.

>west
Savannah
Savannah today

A big and modern glass door. You know, that opaque kind of glass which looks very expensive.

>south
Scientific Base Camp
Present of Antarctica. The only thing you see beyond the camp's igloos is ice and extracted ice caps. You don't want to spend too much time here unless you always wanted to be a human ice cream. The igloos are scattered over a large area, but one is not far away. If you want to go inside, you'll have to crawl through the tunnel.

You can see a tunnel here.

* * *

>south
Mexico City
Gunshots pierce the sky as you cross the road of today's Mexico. It is getting quite dark and you don't want any trouble. You see four similarly unwellcoming alleyways each leading in different directions: south, north, east and west.

>east
Scorpion World
Here you step into the future of Latin America. As time passed, a lot of species went extinct. Not scorpions though, scorpions got bigger. Unfortunately, way bigger than you. The whole contient mutated into a huge conurbation of enormous scorpion nests: you are in the middle of it. In front of you is one of those scorpion nest.

The nest is swarming with "little" scorpions, as big as your head. Inside your head precisely, alongside your fear, your pragmatic common sense tells you something like "don't you think that this baby scorpion's tail could do a marvellous pen?"

>x nest
In the nest is a baby scorpion.

>west
Mexico City
Gunshots pierce the sky as you cross the road of today's Mexico. It is getting quite dark and you don't want any trouble. You see four similarly unwellcoming alleyways each leading in different directions: south, north, east and west.

>east
Scorpion World
Here you step into the future of Latin America. As time passed, a lot of species went extinct. Not scorpions though, scorpions got bigger. Unfortunately, way bigger than you. The whole contient mutated into a huge conurbation of enormous scorpion nests: you are in the middle of it. In front of you is one of those scorpion nest.

The nest is swarming with "little" scorpions, as big as your head. Inside your head precisely, alongside your fear, your pragmatic common sense tells you something like "don't you think that this baby scorpion's tail could do a marvellous pen?"

>attack baby
After an epic battle in which you found yourself without trousers because your belt was the only weapon you could find, you finally manage to finish off the baby scorpion that passes away looking you right in the eyes. To honor this proud and mighty enemy, you decide to craft a pen out of it's tail.

* * *

>south
Souk Ruins
A labyrinthine series of corridors unfolds in front of you. The stones that pave the ground reflect the dazzling sunlight

You can see a Chest (closed) here.

>south
You can't go that way.

>past
Savannah
Savannah today

A big and modern glass door. You know, that opaque kind of glass which looks very expensive.

>south
Scientific Base Camp
Present of Antarctica. The only thing you see beyond the camp's igloos is ice and extracted ice caps. You don't want to spend too much time here unless you always wanted to be a human ice cream. The igloos are scattered over a large area, but one is not far away. If you want to go inside, you'll have to crawl through the tunnel.

You can see a tunnel here.

* * *

>south
Mexico City
Gunshots pierce the sky as you cross the road of today's Mexico. It is getting quite dark and you don't want any trouble. You see four similarly unwellcoming alleyways each leading in different directions: south, north, east and west.

>past
Aztec Temple
The humming of a ritual chant bounces on the stone walls, you came right on time for the human sacrifice ! It seems like you landed in the past of Latin America and that the great Aztec civilization is at its peak.

A middle sized wall built in a strangely intelligent way with huge stones. It is too big for you to climb..

You can also see an Aztec Statue here.

>x statue
A representation of Quetzalcóatl, the snake-god. It is cubical and stable. It stands just in front of the wall, behind which is a strange place that looks like a landfill site but instead of broken washing machines and old lamps, a lot of yellow-white sticks and balls with wholes are laying there...

>get on statue
You get onto the Aztec Statue.

>climb up
You must name something more substantial.

>climb the wall
(first getting off the Aztec Statue)
As you are not an athlete, this operation is proving very difficult; but you manage to pull yourself up.

Ritual Waste
This place reminds you why you dont like BBQ: mostly because of the smell... While you are wondering why you got up here, your eyes are caught by what seems to be a human collarbone. It is strangely sharp, it almost look like a pen..

>go down
You jump from the wall on the statue and then on the ground. You hurry up because you can hear the ritual chant getting closer!

Aztec Temple
The humming of a ritual chant bounces on the stone walls, you came right on time for the human sacrifice ! It seems like you landed in the past of Latin America and that the great Aztec civilization is at its peak.

A middle sized wall built in a strangely intelligent way with huge stones. It is too big for you to climb..

You can also see an Aztec Statue here.

* * *

>west
You can't go that way.

>crawl
(in the entrance tunnel)

Igloo
You cannot see much, but a dying fire sufficiently illuminates the place to be able to see the room made of ice. At the back of the igloo, you see a sleeping person. He looks like a researcher, he certainly writes things down everyday...

You can see an entrance tunnel and a sleeping researcher here.

>crawl
What do you want to crawl in?

* * *

>up
Scientific Base Camp
Present of Antarctica. The only thing you see beyond the camp's igloos is ice and extracted ice caps. You don't want to spend too much time here unless you always wanted to be a human ice cream. The igloos are scattered over a large area, but one is not far away. If you want to go inside, you'll have to crawl through the entrance tunnel.

You can see an entrance tunnel here.

>south
Mexico City
Gunshots pierce the sky as you cross the road of today's Mexico. It is getting quite dark and you don't want any trouble. You see four similarly unwellcoming alleyways each leading in different directions: south, north, east and west.

>east
Scorpion World
Here you step into the future of Latin America. As time past, a lot of species went extinct. Not scorpions though, scorpions got bigger. Unfortunately, way bigger than you. The whole contient mutated into a huge conurbation of enormous scorpion nests: you are in the middle of it. In front of you is one of those scorpion nest.

The nest is swarming with "little" scorpions, as big as your head. Inside your head precisely, alongside your fear, your pragmatic common sense tells you something like "don't you think that this baby scorpion's tail could do a marvellous pen?"

* * *

>x nest
In the nest is a baby scorpion.

>x baby
You see nothing special about the baby scorpion.

>west
Mexico City
Gunshots pierce the sky as you cross the road of today's Mexico. It is getting quite dark and you don't want any trouble. You see four similarly unwellcoming alleyways each leading in different directions: south, north, east and west.

>north
Scientific Base Camp
Present of Antarctica. The only thing you see beyond the camp's igloos is ice and extracted ice caps. You don't want to spend too much time here unless you always wanted to be a human ice cream. The igloos are scattered over a large area, but one is not far away. If you want to go inside, you'll have to crawl through the entrance tunnel.

You can see an entrance tunnel here.

>crawl
(in the entrance tunnel)

Igloo
You cannot see much, but a dying fire sufficiently illuminates the place to be able to see the room made of ice. At the back of the igloo, you see a sleeping person. He looks like a researcher, he certainly writes things down everyday...

You can see an entrance tunnel and a sleeping researcher here.

>crawl in the entrance tunnel
Scientific Base Camp
Present of Antarctica. The only thing you see beyond the camp's igloos is ice and extracted ice caps. You don't want to spend too much time here unless you always wanted to be a human ice cream. The igloos are scattered over a large area, but one is not far away. If you want to go inside, you'll have to crawl through the entrance tunnel.

You can see an entrance tunnel here.

* * *

>west
You can't go that way.

>east
Scientific Base Camp
Present of Antarctica. The only thing you see beyond the camp's igloos is ice and extracted ice caps. You don't want to spend too much time here unless you always wanted to be a human ice cream. The igloos are scattered over a large area, but one is not far away. If you want to go inside, you'll have to crawl through the tunnel.

You can see a tunnel here.

>south
Mexico City
Gunshots pierce the sky as you cross the road of today's Mexico. It is getting quite dark and you don't want any trouble. You see four similarly unwellcoming alleyways each leading in different directions: south, north, east and west.

* * *

>south
Wuhan
A new, deadly virus was detected for the first time here. The city center is deserted, while the hospitals and morgues are filled with covid patients. You don't have a mask, you not even have a scarf to put around your mouth and nose... it might be better to leave Wuhan as fast as possible!!

>south
New Delhi
You are now in the city center of New Dehli nowadays: your senses are flooded with all kinds of informations. The smells of a thousand spices assault your nostrils from a street market on your right hand and their colors fill up your soul like flowers in the spring, birds are singing and market sellers seems to be answering them prices of their marchandises, the whole thing is wrapped up in a whirlwind of scooters and tuktuk that add a deeply human touch to the frenzy of the moment.

A big and modern glass door. You know, that opaque kind of glass which looks very expensive. Of course you'd know, your office has the same ones.

* * *

>west
You can't go that way.

>south
(first opening the shiny door)
It seems to be locked.

>east
(first opening the familiar looking door)
It seems to be locked.

* * *

>x
(the Astec Statue)
A representation of Quetzalcóatl, the snake-god. It is cubical and stable. It stands just in front of a wall, behind which is a strange place that looks like a landfill site but instead of broken washing machines and old lamps, a lot of yellow-white sticks and balls with wholes are laying there...

>climb
What do you want to climb?

>climb the wall
You can't see any such thing.

* * *

>x nest
In the nest is a baby scorpion.

>x baby
One of the baby scorpion - that you surprisingly find cute with its sharp little claws, its hairy exoskeleton and its menacing scorpion's tail dancing gently in the warm wind - comes to you, certainly interested by your delicious monkey shape. Violence is never an answer - but now that you are in front of the scorpion that keeps coming closer, saliva dripping from its lips, I would suggest you to attack it!

* * *

>open door
Which do you mean, the shiny door, the modern glass door, the back door, the familiar looking door or the big door?

>open big door
Office
Your boss and yourself are in the midst of stormy negotiations with new potential associates. The atmosphere is tense, so much so that you can feel sweat beads dripping down your tailored shirt as your sticky hands pound on your laptop keyboard. Your boss sits at your left while two other gentlemen sit straight across from you both. All of you have been in here, bargaining over contract terms, for quite a while now and you wrists are staring to ache as you write and erase what the others tell you to. The shadows you cast on the white office walls gently shift as the sun goes down,  you wish they had come up to an agreement by now.

Suddenly, either out of weariness or out of boldness, one of your guests leans in towards you and suggests a daring idea. You see a spark light up everybody else's as the idea sinks a little deeper in all of your minds.

-This is great ..! says your boss.

- This is illegal. you respond. Completely astonished by the nature of such suggestions.

- You're right, this can't appear on the records. Put that computer aside and grab a piece of paper! he adds.

You look around but can't seem to find any paper laying around. New ideas flood the room and you are not able the write any of them down. You painfully interrupt this flow of thoughts:

-Sir, I don't think we have any paper nor any pens. The bubbly brainstorm turns into three heavy stairs, the kind of stairs that strip you from your will to disagree.

- Would you be so kind as to go and fetch some for us ? asks the scarier of the two guest.

-Yes, of course. you respond as you quickly get up. 

Now out of your Leather chair, you take a last look at the conference table. You think to yourself:

- No paper, no pens, is this really it? The office of the future?

It can't be. All it is, is a realm of shiny metals and cold greatings. Your buzzing laptop the stainless glass door, the cold coffee you drink, everything you lay your eyes on is chilling.

Going for a strawl could be exactly what you need. Suddenly, you catch yourself hoping for a paper shortage in the whole damn building or, better even, in the whole damn town. So you'd have an excuse to put some miles between you and this place.

You can also see a big door here.

>look scorpions nest
You can't see any such thing.

>look at nest
You can't see any such thing.

>go north
(first opening the modern glass door)
It seems to be locked.

>look flying car
You can't see any such thing.

>look car
You can't see any such thing.

>go south
(first opening the shiny door)
It seems to be locked.

>go south
(first opening the shiny door)
It seems to be locked.

>go east
(first opening the familiar looking door)
It seems to be locked.

>go west
(first opening the back door)
this door looks locked and you have a feeling only magic could help you get threw it.

>go east
(first opening the familiar looking door)
It seems to be locked.

>go east
(first opening the familiar looking door)
It seems to be locked.

>look at floating car
You can't see any such thing.

>look at car
You can't see any such thing.

>take pass
You can't see any such thing.

>go south
(first opening the shiny door)
It seems to be locked.

>open door
Which do you mean, the shiny door, the modern glass door, the back door, the familiar looking door or the big door?

>unlock door
Which do you mean, the shiny door, the modern glass door, the back door, the familiar looking door or the big door?

>open door
Which do you mean, the shiny door, the modern glass door, the back door, the familiar looking door or the big door?

>go west
(first opening the back door)
this door looks locked and you have a feeling only magic could help you get threw it.

I beg your pardon?

>go north
(first opening the modern glass door)
It seems to be locked.

>open big door
Druid's tent
an old Celtic druid's tent, just like you imagined them. Drapy curtens frame passageways going north and south, they are too thick for you to see threw them. At the very back of the tent, behind all of the mess, you see a back door. Strangely enough, it looks like the one form your office 

The tent is cramped with peculiar shelves. They are made of thick lumber on which rests an army of glass jars filled with colorful liquids. Each jar is labeled with small srips of paper filled with a handwriting you can bearly decipher.

You can also see a small altar (on which are a rounded jar (closed), a skinny jar (closed) and pear shaped jar (closed)) and a cauldron here.

>go south
Alexandria's Library
This is probably the greatest sanctuary of knowledge of all time. There are tons of books in there. They don't seem to be arranged in any specific order. You realize just how much looking up stuff was an elephantine task before the Internet.

You can see 100 books here.

* * *

>go south
Aztec temple
The humming of a ritual chant bounces on the stone walls, you came right on time for the human sacrifice ! It seems like you landed in the past of Latin America and that the great Aztec civilization is at its peak.

A middle sized wall built in a strangely intelligent way with huge stones. It is too big for you to climb..

You can also see an Aztec Statue here.

>go east
Mexico City
Gunshots pierce the sky as you cross the road of today's Mexico. It is getting quite dark and you don't want any trouble. You see four similarly unwellcoming alleyways each leading in different directions: south, north, east and west.

>look at black jack
You can't see any such thing.

>go west
Aztec temple
The humming of a ritual chant bounces on the stone walls, you came right on time for the human sacrifice ! It seems like you landed in the past of Latin America and that the great Aztec civilization is at its peak.

A middle sized wall built in a strangely intelligent way with huge stones. It is too big for you to climb..

You can also see an Aztec Statue here.

>look at black jack
You can't see any such thing.

>go west
You can't go that way.

>go south
Chinese Workshop
A small and dusty room, with a little window that opens to a wide rice field. The air is tick and gloomy due to the arrival of the rain season. An old artisan wearing a straw hat and loose hemp clothes made is making rice paper at the back of the room. You slowly approach the man and, after bending towards in sign of respect, you ask him:

- Sir, may I borrow one of these please?

- Yes, of course, go ahead.

* * *

>go south
Maharaja's palace
The imposing white marble palace is surrounded by the magnificent gardens of prince Abdul the second. Multiple fountains provide fresh water for the animals that reside in the gardens: birds of all colors and sizes that sing from dawn till dusk, little monkeys that jump from tree to tree and try to steal whatever you're eating, and beautiful colorful peacocks that turn around.

Looking one of the peacocks, you think to yourself: I bet I could use one of its feathers as a pen...

You can see a Peacock here.

>take skinny
You can't see any such thing.

* * *

>read skinny
You can't see any such thing.

>read label of skinny
You can't see any such thing.

>read what's on skinny jar
You can't see any such thing.

>read skinny jar¨
You can't see any such thing.

>read skinny jar
You can't see any such thing.

>open jar
You can't see any such thing.

>drink liquid
You can't see any such thing.

>read label skinny
You can't see any such thing.

>go south
Druid's tent
an old Celtic druid's tent, just like you imagined them. Drapy curtens frame passageways going north and south, they are too thick for you to see threw them. At the very back of the tent, behind all of the mess, you see a back door. Strangely enough, it looks like the one form your office 

The tent is cramped with peculiar shelves. They are made of thick lumber on which rests an army of glass jars filled with colorful liquids. Each jar is labeled with small srips of paper filled with a handwriting you can bearly decipher.

You can also see a small altar (on which are a rounded jar (closed), a skinny jar (closed) and pear shaped jar (closed)) and a cauldron here.

* * *

>go south
Aztec temple
The humming of a ritual chant bounces on the stone walls, you came right on time for the human sacrifice ! It seems like you landed in the past of Latin America and that the great Aztec civilization is at its peak.

A middle sized wall built in a strangely intelligent way with huge stones. It is too big for you to climb..

You can also see an Aztec Statue here.

>take skinny
You can't see any such thing.

>read label of skinny
You can't see any such thing.

>read the label of skinny
You can't see any such thing.

>open skinnny
You can't see any such thing.

>open skinny jar
You can't see any such thing.

>examine skinny jar
You can't see any such thing.

* * *

>run away
You can't see any such thing.

>door
That's not a verb I recognise.

>catch
That's not a verb I recognise.

>look
Office
Your boss and yourself are in the midst of stormy negotiations with new potential associates. The atmosphere is tense, so much so that you can feel sweat beads dripping down your tailored shirt as your sticky hands pound on your laptop keyboard. Your boss sits at your left while two other gentlemen sit straight across from you both. All of you have been in here, bargaining over contract terms, for quite a while now and you wrists are staring to ache as you write and erase what the others tell you to. The shadows you cast on the white office walls gently shift as the sun goes down,  you wish they had come up to an agreement by now.

Suddenly, either out of weariness or out of boldness, one of your guests leans in towards you and suggests a daring idea. You see a spark light up everybody else's as the idea sinks a little deeper in all of your minds.

-This is great ..! says your boss.

- This is illegal. you respond. Completely astonished by the nature of such suggestions.

- You're right, this can't appear on the records. Put that computer aside and grab a piece of paper! he adds.

You look around but can't seem to find any paper laying around. New ideas flood the room and you are not able the write any of them down. You painfully interrupt this flow of thoughts:

-Sir, I don't think we have any paper nor any pens. The bubbly brainstorm turns into three heavy stairs, the kind of stairs that strip you from your will to disagree.

- Would you be so kind as to go and fetch some for us ? asks the scarier of the two guest.

-Yes, of course. you respond as you quickly get up. 

Now out of your Leather chair, you take a last look at the conference table. You think to yourself:

- No paper, no pens, is this really it? The office of the future?

It can't be. All it is, is a realm of shiny metals and cold greatings. Your buzzing laptop the stainless glass door, the cold coffee you drink, everything you lay your eyes on is chilling.

Going for a strawl could be exactly what you need. Suddenly, you catch yourself hoping for a paper shortage in the whole damn building or, better even, in the whole damn town. So you'd have an excuse to put some miles between you and this place.

You can also see a big door here.

>open
What do you want to open?

>door
Which do you mean, the shiny door, the modern glass door, the back door, the familiar looking door or the big door?

>open door
Which do you mean, the shiny door, the modern glass door, the back door, the familiar looking door or the big door?

* * *

>south
Savannah
Savannah today

>north
Office
Your boss and yourself are in the midst of stormy negotiations with new potential associates. The atmosphere is tense, so much so that you can feel sweat beads dripping down your tailored shirt as your sticky hands pound on your laptop keyboard. Your boss sits at your left while two other gentlemen sit straight across from you both. All of you have been in here, bargaining over contract terms, for quite a while now and you wrists are staring to ache as you write and erase what the others tell you to. The shadows you cast on the white office walls gently shift as the sun goes down,  you wish they had come up to an agreement by now.

Suddenly, either out of weariness or out of boldness, one of your guests leans in towards you and suggests a daring idea. You see a spark light up everybody else's as the idea sinks a little deeper in all of your minds.

-This is great ..! says your boss.

- This is illegal. you respond. Completely astonished by the nature of such suggestions.

- You're right, this can't appear on the records. Put that computer aside and grab a piece of paper! he adds.

You look around but can't seem to find any paper laying around. New ideas flood the room and you are not able the write any of them down. Your painfully interrupt this flow thoughts:

-Sir, I don't think we have any paper nor any pens. The bubbly brainstorm turns into three heavy stairs, the kind of stairs that strip you from your will to disagree.

- Would you be so kind as to go and fetch some for us ? asks the scarier of the two guest.

-Yes, of course. you respond as you quickly get up. 

You can see a back door, a familiar looking door, a Leather chair and a conference table (on which are your laptop and several coffee mugs) here.

>south
Savannah
Savannah today

>south
Scientific base camp
The only thing you see beyond the camp's igloos is ice and extracted ice caps. You don't want to spend too much time here unless you always wanted to be a human ice cream. The igloos are scattered over a large area, but one is not far away. If you want to go inside, you'll have to crawl through the entrance tunnel.

You can see an entrance tunnel here.

>down
Igloo
You cannot see much, but a dying fire sufficiently illuminates the place to be able to see the room made of ice. At the back of the igloo, you see a sleeping person.

You can see an entrance tunnel here.

>x person
The sleeping guy has papers and tools around him. It look like he is a scientist. He sleeps like a log.

>search person
There is nothing on the sleeping person.

* * *

>south
Savannah
Savannah today

>south
Scientific Base Camp
The only thing you see beyond the camp's igloos is ice and extracted ice caps. You don't want to spend too much time here unless you always wanted to be a human ice cream. The igloos are scattered over a large area, but one is not far away. If you want to go inside, you'll have to crawl through the entrance tunnel.

You can see an entrance tunnel here.

>crawl
You must supply a noun.

>crawl the entrance tunnel
I only understood you as far as wanting to crawl.

* * *

>south
Scientific Base Camp
The only thing you see beyond the camp's igloos is ice and extracted ice caps. You don't want to spend too much time here unless you always wanted to be a human ice cream. The igloos are scattered over a large area, but one is not far away. If you want to go inside, you'll have to crawl through the entrance tunnel.

You can see an entrance tunnel here.

>crawl
(in the entrance tunnel)

Igloo
You cannot see much, but a dying fire sufficiently illuminates the place to be able to see the room made of ice. At the back of the igloo, you see a sleeping person. He looks like a researcher, he certainly writes things down everyday...

You can see an entrance tunnel and a sleeping researcher here.

>crawl the entrance tunnel
I only understood you as far as wanting to crawl.

>crawl
You must supply a noun.

>crawl
You must supply a noun.

* * *

>crawl the entrance tunnel
I only understood you as far as wanting to crawl.

>down
Igloo
You cannot see much, but on your right is a sleeping scientist.

You can see an entrance tunnel here.

>up
Scientific base camp
The only thing you see beyond the camp's igloos is ice and extracted ice caps. You don't want to spend too much time here unless you always wanted to be a human ice cream. The igloos are scattered over a large area, but one is not far away. If you want to go inside, you'll have to crawl through the entrance tunnel.

You can see an entrance tunnel here.

* * *

>crawl
(in the entrance tunnel)

Igloo
You cannot see much, but a dying fire sufficiently illuminates the place to be able to see the room made of ice. At the back of the igloo, you see a sleeping person. He looks like a researcher, he certainly writes things down everyday...

You can see an entrance tunnel and a sleeping researcher here.

>down
Igloo
You cannot see much, but at the back is a sleeping scientist.

You can see an entrance tunnel here.

* * *

>crawl
(in the entrance tunnel)

Igloo
You cannot see much, but a dying fire sufficiently illuminates the place to be able to see the room made of ice. At the back of the igloo, you see a sleeping person. He looks like a researcher, he certainly writes things down everyday...

You can see an entrance tunnel and a sleeping researcher here.

>search the researcher
You lift the multiple layers of blankets and fur and after a quick search you see something shiny that catches your frozen eyes: a Mont Blanc quill! Exactly what your boss needs to sign the contract. After a brief discussion with your conscience, you decide to take it.

>i
You are carrying:
  a Mont Blanc quill

* * *

>crawl
(in the entrance tunnel)

Igloo
You cannot see much, but a dying fire sufficiently illuminates the place to be able to see the room made of ice. At the back of the igloo, you see a sleeping person. He looks like a researcher, he certainly writes things down everyday...

You can see an entrance tunnel and a sleeping researcher here.

>x
(the entrance tunnel)
You see nothing special about the entrance tunnel.

>go down
Igloo
You cannot see much, but a dying fire sufficiently illuminates the place to be able to see the room made of ice. At the back of the igloo, you see a sleeping person. He looks like a scientist, he certainly writes things down everyday...

You can see an entrance tunnel here.

* * *

>crawl
(in the entrance tunnel)

Igloo
You cannot see much, but a dying fire sufficiently illuminates the place to be able to see the room made of ice. At the back of the igloo, you see a sleeping person. He looks like a researcher, he certainly writes things down everyday...

You can see an entrance tunnel and a sleeping researcher here.

>x person
You can't see any such thing.

>search person
You can't see any such thing.

>crawl
What do you want to crawl in?

>w
You can't go that way.

>e
You can't go that way.

>crawl
What do you want to crawl in?

* * *

>south
Scientific Base Camp
The only thing you see beyond the camp's igloos is ice and extracted ice caps. You don't want to spend too much time here unless you always wanted to be a human ice cream. The igloos are scattered over a large area, but one is not far away. If you want to go inside, you'll have to crawl through the entrance tunnel.

You can see an entrance tunnel here.

>down
Igloo
You cannot see much, but a dying fire sufficiently illuminates the place to be able to see the room made of ice. At the back of the igloo, you see a sleeping person. He looks like a scientist, he certainly writes things down everyday...

You can see an entrance tunnel here.

>open sleeping scientist
You can't see any such thing.

* * *

>down
Igloo
You cannot see much, but a dying fire sufficiently illuminates the place to be able to see the room made of ice. At the back of the igloo, you see a sleeping person. He looks like a scientist, he certainly writes things down everyday...

You can see an entrance tunnel here.

>search person
There is nothing on the sleeping person.

* * *

>down
Igloo
You cannot see much, but a dying fire sufficiently illuminates the place to be able to see the room made of ice. At the back of the igloo, you see a sleeping person. He looks like a scientist, he certainly writes things down everyday...

You can see an entrance tunnel here.

>up
You can't go that way.

>crawl
You must supply a noun.

>crawl the tunnel
I only understood you as far as wanting to crawl.

>down
You can't go that way.

>x sleeping scientist
You can't see any such thing.

* * *

>down
Igloo
You cannot see much, but a dying fire sufficiently illuminates the place to be able to see the room made of ice. At the back of the igloo, you see a sleeping person. He looks like a scientist, he certainly writes things down everyday...

You can see an entrance tunnel here.

>x person
The sleeping guy has papers and tools around him. It look like he is a scientist. He sleeps like a log.

>search the person
There is nothing on the sleeping person.

* * *

>down
Igloo
You cannot see much, but a dying fire sufficiently illuminates the place to be able to see the room made of ice. At the back of the igloo, you see a sleeping person. He looks like a scientist, he certainly writes things down everyday...

You can see an entrance tunnel here.

>x sleepind scientist
You can't see any such thing.

>x sleeping scientist
I only understood you as far as wanting to examine the sleeping person.