Open Space
An Interactive Fiction by Thalie Schmidt, Laura Pippus, David Pavlik et Ludovic Rochat
Release 1 / Serial number 210602 / Inform 7 build 6M62 (I6/v6.34 lib 6/12N) SD

The Office
Your boss and yourself are in the midst of stormy negotiations with new potential associates. The atmosphere is tense, so much so that you can feel sweat beads dripping down your tailored shirt as your sticky hands pound on your laptop keyboard. Your boss sits at your left while two other gentlemen sit straight across from you both. All of you have been in here, bargaining over contract terms, for quite a while now and you wrists are staring to ache as you write and erase what the others tell you to. The shadows you cast on the white office walls gently shift as the sun goes down,  you wish they had come up to an agreement by now.

 Suddenly, either out of weariness or out of boldness, one of your guests leans in towards you and suggests a daring idea. You see a spark light up everybody else's as the idea sinks a little deeper in all of your minds. 
 - This is great ..! says your boss.
 - This is illegal. you respond, completely astonished by the nature of such suggestions.
 - You're right, this can't appear on the records. Put that computer aside and grab a piece of paper! he adds. 

 You look around but can't seem to find any paper laying around. New ideas flood the room and you are not able the write any of them down. You painfully interrupt this flow of thoughts:  
 - Sir, I don't think we have any paper nor any pens. 
 The bubbly brainstorm turns into three heavy stares, the kind of stares that strip you from your will to disagree.
 - Would you be so kind as to go and fetch some for us ? asks the scarier of the two guest.
 - Yes, of course. you respond as you quickly get up.

Now out of your leather chair, you take a last look at the conference table. You think to yourself: 
No paper, no pens, is this really it? The office of the future?
It can't be. All it is, is a realm of shiny metals and cold greatings. Your buzzing laptop the stainless glass door, the cold coffee you drink, everything you lay your eyes on is chilling.
Going for a strawl could infact be exactly what you need. Suddenly, you catch yourself hoping for a paper shortage in the whole damn building or, even better, in the whole damn town. So you'd have an excuse to put some miles between you and this place.

You can see a big door here.

I beg your pardon?

>open big door
The shaking ground gets you out of your reveries. Is it an earthquake ? Is it a bomb ? In any case you hold on to that door knob with all your strength. Too bad, a strong wind sucks you inward before you can gasp for help.  

 Well well, dear player, the dimesions heard you and sent you quite far away. As you just entered a time and space traveling journey you ought to know that taking a strall to the east fast forwards you to the futur, the west brings you back to the past. As for north and south, they will change your location, letting you roam threw different continents.  

One has to be careful with what he wishes for nowadays... Wherever you land, you better find your way back to your meeting, fast, and with the correct supplies.

If you insist.

On the battlefield against the Corono Virus
The first that were touched by the disease, were the people of Wuhan
You were one of them.

    *** The End ***

Would you like to RESTART, RESTORE a saved game, QUIT or UNDO the last command?

>go east
Please give one of the answers above.

Would you like to RESTART, RESTORE a saved game, QUIT or UNDO the last command?

>go south
Please give one of the answers above.

Would you like to RESTART, RESTORE a saved game, QUIT or UNDO the last command?

>go south
Please give one of the answers above.

Would you like to RESTART, RESTORE a saved game, QUIT or UNDO the last command?

>take scally skin
Please give one of the answers above.

Would you like to RESTART, RESTORE a saved game, QUIT or UNDO the last command?

>scaly skin
Please give one of the answers above.

Would you like to RESTART, RESTORE a saved game, QUIT or UNDO the last command?

>take scaly skin
Please give one of the answers above.

Would you like to RESTART, RESTORE a saved game, QUIT or UNDO the last command?

>take stick
Please give one of the answers above.

Would you like to RESTART, RESTORE a saved game, QUIT or UNDO the last command?

>take scaly skin
Please give one of the answers above.

Would you like to RESTART, RESTORE a saved game, QUIT or UNDO the last command?

>go south
Please give one of the answers above.

Would you like to RESTART, RESTORE a saved game, QUIT or UNDO the last command?

>go east
Please give one of the answers above.

Would you like to RESTART, RESTORE a saved game, QUIT or UNDO the last command?

>go east
Please give one of the answers above.

Would you like to RESTART, RESTORE a saved game, QUIT or UNDO the last command?

* * *

>go south
Please give one of the answers above.

Would you like to RESTART, RESTORE a saved game, QUIT or UNDO the last command?

>take stick
Please give one of the answers above.

Would you like to RESTART, RESTORE a saved game, QUIT or UNDO the last command?

* * *

>open big door
The shaking ground gets you out of your reveries. Is it an earthquake ? Is it a bomb ? In any case you hold on to that door knob with all your strength. Too bad, a strong wind sucks you inward before you can gasp for help.  

 Well well, dear player, the dimesions heard you and sent you quite far away. As you just entered a time and space traveling journey you ought to know that taking a strall to the east fast forwards you to the futur, the west brings you back to the past. As for north and south, they will change your location, letting you roam threw different continents.  

One has to be careful with what he wishes for nowadays... Wherever you land, you better find your way back to your meeting, fast, and with the correct supplies.

Aztec temple
In the future is Mexico City.
The humming of a ritual chant bounces on the stone walls, you came right on time for the human sacrifice ! It seems like you landed in the past of Latin America and that the great Aztec civilization is at its peak.

A middle sized wall built in a strangely intelligent way with huge stones. It is too big for you to climb..

You can also see an Aztec Statue here.

>climb
What do you want to climb?

>get on aztec statue
You get onto the Aztec Statue.

>climb
What do you want to climb?

>climb wall
(first getting off the Aztec Statue)
As you are not an athlete, this operation is proving very difficult; but you manage to pull yourself up.

Ritual Waste
This place reminds you why you dont like BBQs: mostly because of the smell... While you are wondering why you got up here, your eyes are caught by what seems to be a human collarbone. It is strangely sharp, it almost look like a pen..

You can see a sharp collarbone here.

>take callarbone
You can't see any such thing.

>take pen
You can't see any such thing.

>x callarbone
You can't see any such thing.

* * *

>futur
That's not a verb I recognise.

>future
Mexico City
In the future is Scorpion's World and in the past is an Aztec Temple.
Gunshots pierce the sky as you cross the road of today's Mexico. It is getting quite dark and you don't want any trouble. You see four similarly unwellcoming alleyways each leading in different directions: south, north, east and west.

>south
Wuhan
In the future is a Futuristic Casino and in the past is a Chinese Workshop.
A new, deadly virus was detected for the first time here. The city center is deserted, while the hospitals and morgues are filled with covid patients. You don't have a mask, you not even have a scarf to put around your mouth and nose... 

it might be better for you to leave Wuhan as fast as possible.

You can see a dirty masks here.

>south
New Delhi
In the future is Yogi's retreat and in the past is Maharaja's palace. You are now in the city center of New Dehli nowadays: your senses are flooded with all kinds of informations. The smells of a thousand spices assault your nostrils from a street market on your right hand and their colors fill up your soul like flowers during spring, birds are singing and market sellers seem to be singing out the prices of their marchandises; the whole thing is wrapped up in a whirlwind of scooters and tuktuks, adding a deeply human touch to the frenzy of the moment.

Somewhere in this exotic atmosphere, your eye catches a strange thing that doesn't seem to belong here: a modern glass door. You know, that opaque kind of glass which looks very expensive. Of course you'd know, your office has the same ones!

>north
Wuhan
In the future is a Futuristic Casino and in the past is a Chinese Workshop.
A new, deadly virus was detected for the first time here. The city center is deserted, while the hospitals and morgues are filled with covid patients. You don't have a mask, you not even have a scarf to put around your mouth and nose... 

it might be better for you to leave Wuhan as fast as possible.

You can see a dirty masks here.

>jump
You jump on the spot.

* * *

>future
You can't go that way.

>past
Mexico City
In the future is Scorpion's World and in the past is an Aztec Temple.
Gunshots pierce the sky as you cross the road of today's Mexico. It is getting quite dark and you don't want any trouble. You see four similarly unwellcoming alleyways each leading in different directions: south, north, east and west.

>south
Wuhan
In the future is a Futuristic Casino and in the past is a Chinese Workshop.
A new, deadly virus was detected for the first time here. The city center is deserted, while the hospitals and morgues are filled with covid patients. You don't have a mask, you not even have a scarf to put around your mouth and nose... 

it might be better for you to leave Wuhan as fast as possible.

You can see a dirty masks here.

>jump
If you insist. 
 Many people died on the battlefield against the coronavirus. 
First to be hit were the people of Wuhan.
You were one of them.

    *** The End ***

Would you like to RESTART, RESTORE a saved game, QUIT or UNDO the last command?

* * *

>future
You can't go that way.

>south
Wuhan
In the future is a Futuristic Casino and in the past is a Chinese Workshop.
A new, deadly virus was detected for the first time here. The city center is deserted, while the hospitals and morgues are filled with covid patients. You don't have a mask, you not even have a scarf to put around your mouth and nose... 

it might be better for you to leave Wuhan as fast as possible.

You can see a dirty masks here.

>north
Mexico City
In the future is Scorpion's World and in the past is an Aztec Temple.
Gunshots pierce the sky as you cross the road of today's Mexico. It is getting quite dark and you don't want any trouble. You see four similarly unwellcoming alleyways each leading in different directions: south, north, east and west.

* * *

>jump
You jump on the spot.

>jump
You jump on the spot.

>take
(the dirty masks)
Taken.

>go s
New Delhi
In the future is Yogi's retreat and in the past is Maharaja's palace. To the north is a huge modern city.

 You are now in the city center of New Dehli nowadays: your senses are flooded with all kinds of informations. The smells of a thousand spices assault your nostrils from a street market on your right hand and their colors fill up your soul like flowers during spring, birds are singing and market sellers seem to be singing out the prices of their marchandises; the whole thing is wrapped up in a whirlwind of scooters and tuktuks, adding a deeply human touch to the frenzy of the moment.

Somewhere in this exotic atmosphere, your eye catches a strange thing that doesn't seem to belong here: a modern glass door. You know, that opaque kind of glass which looks very expensive. Of course you'd know, your office has the same ones!

>n
Wuhan
In the future is a Futuristic Casino and in the past is a Chinese Workshop. To the north is a huge modern city and in the opposite direction is filled whit colors, sounds and human interaction.

A new, deadly virus was detected for the first time here. The city center is deserted, while the hospitals and morgues are filled with covid patients. You don't have a mask, you not even have a scarf to put around your mouth and nose... 

it might be better for you to leave Wuhan as fast as possible.

>south
New Delhi
In the future is Yogi's retreat and in the past is Maharaja's palace. To the north is a huge modern city.

 You are now in the city center of New Dehli nowadays: your senses are flooded with all kinds of informations. The smells of a thousand spices assault your nostrils from a street market on your right hand and their colors fill up your soul like flowers during spring, birds are singing and market sellers seem to be singing out the prices of their marchandises; the whole thing is wrapped up in a whirlwind of scooters and tuktuks, adding a deeply human touch to the frenzy of the moment.

Somewhere in this exotic atmosphere, your eye catches a strange thing that doesn't seem to belong here: a modern glass door. You know, that opaque kind of glass which looks very expensive. Of course you'd know, your office has the same ones!

>south
(first opening the modern glass door)
Shouldn't you bring back a pen?
Shouldn't you bring back a paper?

It seems to be locked.

>future
Yogi's retreat
In the past is the city center of New Delhi. South is muddy and wet when north is full of lights and distand hubbub.

 Now, it is the only community still standing in 20900"s India. This sanctuary is filled with trees, and in the network of streams that run around, you can see huge red, orange and white carps. Yoga matresses are pretty much everywhere, and the smell of the incense is just delightful. You feel a big sense of inner peace...

 if you stay here  for too long, you might not find the will to leave.

You can see a relaxing aura here.

>south
Swamps
In south direction you can see something like ruins in the distance. On the opposite direction it seems like there is a temple or a sanctuary.

The air here is breezy. It is hard for you to move comfortably because your feet are plunged in water, or is it silt ? Vegetation is quite dense, reeds and weeds pave your way. If you look west, you can see the framework of a door in the distance. Strangely enough, it looks like the one form your office. There are poorly lit openings in the trees leading either to the north or the south. 

A big and modern glass door. You know, that opaque kind of glass which looks very expensive. This door, however, looks more modern than the ones you have encoutered before, the knob has been replaced by a little blue screen, as if it was meant to be opened with some kind of beeper or pass.

You can also see an Aligator (on which is scaly skin) and a long wooden stick here.

>south
Souk Ruins
The past and north is what some would call a wildlife sanctuaries, although they nest very different creatures. as for the south, it leads to every city men's dream: The peak of urban modernism. 

A labyrinthine series of corridors unfolds in front of you. The stones that pave the ground reflect the dazzling sunlight

You can see a Chest (closed) here.

>south
Utopian City
North is full of ruins when south is swarming with strange and enormous insects.

 Here, cars finally float on air cushions and plants co-exist with skyscrapers in a friendly and aesthetic way. 

A flying car is floating in front of you.

>past
Scientific Base Camp
Present of Antarctica. In the future, cars a flying and plants living peacefully with humans. The past is white, completely white and frozzen. Don't ask why, but from the south you can here gunshots and a hot breeze caresses your ears. North is hot too, but more primitive.

 The only thing you see beyond the camp's igloos is ice and extracted ice caps. You don't want to spend too much time here unless you always wanted to be a human ice cream. The igloos are scattered over a large area, but one is not far away. If you want to go inside, you'll have to crawl through the tunnel.

You can see a tunnel here.

>past
Blizzard
The future looks kind of the same as here, but lest hostile and with igloos. South is a temple and you can hear what seems to be sacred chants. North is filled with knowledge.

 Leave this place, you are in a primitive icy storm. The wind pierces your clothes and shut your eyes closed. You don't want to spend too much time in here. As you are reading this, your toes are getting frozen and threatens to fall. With your office clothes, you don't stand a chance. If you stay here few more seconds, you'll never see your beloved office again.

You can see an ice storm here.

>jump
Oh no. 

You'd like to get back to a warm climate but your feet won't move. Your body doen't respond to external situmli anymore and your feel tired.

Let this blizzard be your final destination.

    *** The End ***

Would you like to RESTART, RESTORE a saved game, QUIT or UNDO the last command?

* * *

>jump
You jump on the spot.

>south
Chinese Workshop
In the future is Wuhan. In the north - deep in the distance - lays a huge brown and gold temple, could be in South America. If you turn you back to it, you can see another temple which looks more like a sanctuary, asian style.

 This workshop is A small and dusty room, with a little window that opens to a wide rice field. The air is tick and gloomy due to the arrival of the rain season. An old artisan wearing a straw hat and loose hemp clothes is making rice paper at the back of the room. You slowly approach the man and, after bending towards in sign of respect, you ask him: - Sir, may I borrow one of these papers please? - Yes, of course, go ahead.

You can see an artisan here.

>futur
That's not a verb I recognise.

>future
Wuhan
In the future is a Futuristic Casino and in the past is a Chinese Workshop. To the north is a huge modern city and in the opposite direction is filled whit colors, sounds and human interaction.

A new, deadly virus was detected for the first time here. The city center is deserted, while the hospitals and morgues are filled with covid patients. You don't have a mask, you not even have a scarf to put around your mouth and nose... 

it might be better for you to leave Wuhan as fast as possible.

You can see a dirty masks here.

>past
Chinese Workshop
In the future is Wuhan. In the north - deep in the distance - lays a huge brown and gold temple, could be in South America. If you turn you back to it, you can see another temple which looks more like a sanctuary, asian style.

 This workshop is A small and dusty room, with a little window that opens to a wide rice field. The air is tick and gloomy due to the arrival of the rain season. An old artisan wearing a straw hat and loose hemp clothes is making rice paper at the back of the room. You slowly approach the man and, after bending towards in sign of respect, you ask him: - Sir, may I borrow one of these papers please? - Yes, of course, go ahead.

You can see an artisan here.

>past
You can't go that way.

>x peacock
You can't see any such thing.

>take peacock
You can't see any such thing.

>attack peacock
You can't see any such thing.

>touch peacock
You can't see any such thing.

>i
You are carrying nothing.

>catch peacock
You can't see any such thing.

>south
Maharaja's palace
In the future is the city center of New Delhi. From what you can see, south seems like a place in north europa when north looks more chinese. It is definitely difficult to understand the geography of this strange world. 

 The imposing white marble palace is surrounded by the magnificent gardens of prince Abdul the second. Multiple fountains provide fresh water for the animals that reside in the gardens: birds of all colors and sizes that sing from dawn till dusk, little monkeys that jump from tree to tree while attempting to steal whatever you're eating, as welll as magestic and colorful peacocks spreading their feathers into gorgeous fans. While ooking at one of the peacocks, you think to yourself: I bet I could use one of its feathers as a pen...

You can see a Peacock here.

>catch peacock
You run after the peacock while it opens its plumage exhibiting the eye-catching pattern. It has so many feathers, but you only need one After minutes running in the labyrinth-like garden under the sizzling sun, you manage to corner the peacock and you finally get your feather.

>i
You are carrying:
  a feather

>south
Druid's tent
To the south,  you can see a huge marble palace far away. When you look to the north, it seems like there is an ancient building in a hot place.

An old Celtic druid's tent, just like you imagined them. Drapy curtens frame passageways going north and south, they are too thick for you to see threw them. At the very back of the tent, behind all of the mess, you see a back door. Strangely enough, it looks like the one form your office 

The tent is cramped with peculiar shelves. They are made of thick lumber on which rests an army of glass jars filled with colorful liquids. Each jar is labeled with small srips of paper filled with a handwriting you can bearly decipher.

You can also see a small altar (on which are a rounded jar (closed), a skinny jar (closed) and pear shaped jar (closed)) and a cauldron here.

>open jar
Which do you mean, the rounded jar, the skinny jar or pear shaped jar?

>open skinny jar
You open the skinny jar, revealing an orange liquid.

>read label skinny jar
(first taking the skinny jar)
you squinkt your eyes: "tears of sunshine: good for opening doors"  mmmh...

>take jar
Which do you mean, the rounded jar, pear shaped jar or the skinny jar?

>take skinny jar
You already have that.

>i
You are carrying:
  a skinny jar (open)
    an orange liquid
  a feather

>south
Alexandria's Library
The future and the south offer landscapes worthy of a BBC documentary, although the former garentees  warm weather while the latter promises frost bites. The north holds magic and mystical encounters. 

This is probably the greatest sanctuary of knowledge of all time. There are tons of books in there. They don't seem to be arranged in any specific order. You realize just how much looking up stuff was an elephantine task before the Internet.

You can see one hundred Books here.

>browse books
You can't use multiple objects with that verb.

>browse book
The book is written in an ancient language you have never seen before. You don't understand anything. Try another one.

>browse book
The book is written in an ancient language you have never seen before. You don't understand anything. Try another one.

>browse book
There is a Blank Page in the book. You tear it and put it in your pocket.

>i
You are carrying:
  a Blank Page
  a skinny jar (open)
    an orange liquid
  a feather

>south
Blizzard
The future looks kind of the same as here, but lest hostile and with igloos. South is a temple and you can hear what seems to be sacred chants. North is filled with knowledge.

 Leave this place, you are in a primitive icy storm. The wind pierces your clothes and shut your eyes closed. You don't want to spend too much time in here. As you are reading this, your toes are getting frozen and threatens to fall. With your office clothes, you don't stand a chance. If you stay here few more seconds, you'll never see your beloved office again.

You can see an ice storm here.

>north
Alexandria's Library
The future and the south offer landscapes worthy of a BBC documentary, although the former garentees  warm weather while the latter promises frost bites. The north holds magic and mystical encounters. 

This is probably the greatest sanctuary of knowledge of all time. There are tons of books in there. They don't seem to be arranged in any specific order. You realize just how much looking up stuff was an elephantine task before the Internet.

You can see one hundred Books here.

>north
Druid's tent
To the south,  you can see a huge marble palace far away. When you look to the north, it seems like there is an ancient building in a hot place.

An old Celtic druid's tent, just like you imagined them. Drapy curtens frame passageways going north and south, they are too thick for you to see threw them. At the very back of the tent, behind all of the mess, you see a back door. Strangely enough, it looks like the one form your office 

The tent is cramped with peculiar shelves. They are made of thick lumber on which rests an army of glass jars filled with colorful liquids. Each jar is labeled with small srips of paper filled with a handwriting you can bearly decipher.

You can also see a small altar (on which are a rounded jar (closed) and pear shaped jar (closed)) and a cauldron here.

>x door
You see nothing special about the back door.

>open door
 Wasn't there a special potion you had in store for these kinds of situations..?

>drink orange liquid
You feel ancestral powers fuzzing threw you.

>open door
 The same fuzz you felt before now runs threw your fingertips. As you touch the door nob you hear the lock pop and the big door slam open. 
office
This place looks uncannily familiar. You can feel memories of calmer times resonate in your mind.  Is this where we came in?... Your boss is standing in a corner of the room and appears to be in a state of great agitation. Around the table, two obnoxious businessmen seem to have spend hours snorting cocaine. Talk to the boss.

Somewhere in this exotic atmosphere, your eye catches a strange thing that doesn't seem to belong here: a modern glass door. You know, that opaque kind of glass which looks very expensive. Of course you'd know, your office has the same ones!

A big and modern glass door. You know, that opaque kind of glass which looks very expensive.

A big and modern glass door. You know, that opaque kind of glass which looks very expensive. This door, however, looks more modern than the ones you have encoutered before, the knob has been replaced by a little blue screen, as if it was meant to be opened with some kind of beeper or pass.

You can also see a shiny door and a Boss here.

>talk to the boss
Have you found some paper? We've been waiting for hours and have conceived a flawless method to achieve universal dominion. Show me what you got.

>give paper
You can't see any such thing.

I beg your pardon?

>give blank page
(to the Boss)
The Boss doesn't seem interested.

>give feather
(to the Boss)
The Boss doesn't seem interested.

>feather
That's not a verb I recognise.

>give a feather
(to the Boss)
The Boss doesn't seem interested.

>show feather
(to the Boss)
The boss says: "Ok, this will add a touch of medieval solemnity to our ritual. But you are definitely some kind of crazy clerk. Now listen to our plan and take good notes of it!" Your boring life resumes.

    *** The End ***

Would you like to RESTART, RESTORE a saved game, QUIT or UNDO the last command?

* * *

>north
Blizzard
The future looks kind of the same as here, but lest hostile and with igloos. South is a temple and you can hear what seems to be sacred chants. North is filled with knowledge.

 Leave this place, you are in a primitive icy storm. The wind pierces your clothes and shut your eyes closed. You don't want to spend too much time in here. As you are reading this, your toes are getting frozen and threatens to fall. With your office clothes, you don't stand a chance. If you stay here few more seconds, you'll never see your beloved office again.

You can see an ice storm here.

>north
Alexandria's Library
The future and the south offer landscapes worthy of a BBC documentary, although the former garentees  warm weather while the latter promises frost bites. The north holds magic and mystical encounters. 

This is probably the greatest sanctuary of knowledge of all time. There are tons of books in there. They don't seem to be arranged in any specific order. You realize just how much looking up stuff was an elephantine task before the Internet.

You can see one hundred Books here.

>north
Druid's tent
To the south,  you can see a huge marble palace far away. When you look to the north, it seems like there is an ancient building in a hot place.

An old Celtic druid's tent, just like you imagined them. Drapy curtens frame passageways going north and south, they are too thick for you to see threw them. At the very back of the tent, behind all of the mess, you see a back door. Strangely enough, it looks like the one form your office 

The tent is cramped with peculiar shelves. They are made of thick lumber on which rests an army of glass jars filled with colorful liquids. Each jar is labeled with small srips of paper filled with a handwriting you can bearly decipher.

You can also see a small altar (on which are a rounded jar (closed), a skinny jar (closed) and pear shaped jar (closed)) and a cauldron here.

>north
Maharaja's palace
In the future is the city center of New Delhi. From what you can see, south seems like a place in north europa when north looks more chinese. It is definitely difficult to understand the geography of this strange world. 

 The imposing white marble palace is surrounded by the magnificent gardens of prince Abdul the second. Multiple fountains provide fresh water for the animals that reside in the gardens: birds of all colors and sizes that sing from dawn till dusk, little monkeys that jump from tree to tree while attempting to steal whatever you're eating, as welll as magestic and colorful peacocks spreading their feathers into gorgeous fans. While ooking at one of the peacocks, you think to yourself: I bet I could use one of its feathers as a pen...

You can see a Peacock here.

>north
Chinese Workshop
In the future is Wuhan. In the north - deep in the distance - lays a huge brown and gold temple, could be in South America. If you turn you back to it, you can see another temple which looks more like a sanctuary, asian style.

 This workshop is A small and dusty room, with a little window that opens to a wide rice field. The air is tick and gloomy due to the arrival of the rain season. An old artisan wearing a straw hat and loose hemp clothes is making rice paper at the back of the room. You slowly approach the man and, after bending towards in sign of respect, you ask him: - Sir, may I borrow one of these papers please? - Yes, of course, go ahead.

You can see an artisan here.

>future
Wuhan
In the future is a Futuristic Casino and in the past is a Chinese Workshop. To the north is a huge modern city and in the opposite direction is filled whit colors, sounds and human interaction.

A new, deadly virus was detected for the first time here. The city center is deserted, while the hospitals and morgues are filled with covid patients. You don't have a mask, you not even have a scarf to put around your mouth and nose... 

it might be better for you to leave Wuhan as fast as possible.

You can see a dirty masks here.

>jump
If you insist. 

Many people died on the battlefield against the coronavirus. 

First to be hit were the people of Wuhan.

You were one of them.

    *** The End ***

Would you like to RESTART, RESTORE a saved game, QUIT or UNDO the last command?

* * *

>past
Mexico City
In the future is Scorpion's World and in the past is an Aztec Temple.
Gunshots pierce the sky as you cross the road of today's Mexico. It is getting quite dark and you don't want any trouble. You see four similarly unwellcoming alleyways each leading in different directions: south, north, east and west.

* * *

>south
Wuhan
In the future is a Futuristic Casino and in the past is a Chinese Workshop.
A new, deadly virus was detected for the first time here. The city center is deserted, while the hospitals and morgues are filled with covid patients. You don't have a mask, you not even have a scarf to put around your mouth and nose... 

it might be better for you to leave Wuhan as fast as possible.

You can see a dirty masks here.

>jump
If you insist. 

Many people died on the battlefield against the coronavirus. 

First to be hit were the people of Wuhan.

You were one of them.

    *** The End ***

Would you like to RESTART, RESTORE a saved game, QUIT or UNDO the last command?

* * *

>south
Chinese Workshop
In the future is Wuhan.
This workshop is A small and dusty room, with a little window that opens to a wide rice field. The air is tick and gloomy due to the arrival of the rain season. An old artisan wearing a straw hat and loose hemp clothes is making rice paper at the back of the room. You slowly approach the man and, after bending towards in sign of respect, you ask him: - Sir, may I borrow one of these papers please? - Yes, of course, go ahead.

You can see an artisan here.

>past
Aztec temple
In the future is Mexico City.
 The humming of a ritual chant bounces on the stone walls, you came right on time for the human sacrifice ! It seems like you landed in the past of Latin America and that the great Aztec civilization is at its peak.

A middle sized wall built in a strangely intelligent way with huge stones. It is too big for you to climb..

You can also see an Aztec Statue here.

>get on statue
You get onto the Aztec Statue.

>climb wall
(first getting off the Aztec Statue)
As you are not an athlete, this operation is proving very difficult; but you manage to pull yourself up.

Ritual Waste
This place reminds you why you dont like BBQs: mostly because of the smell... While you are wondering why you got up here, your eyes are caught by what seems to be a human collarbone. It is strangely sharp, it almost look like a pen..

You can see a sharp collarbone here.

>take bone
Taken.

>i
You are carrying:
  a sharp collarbone

>go down
You jump from the wall on the statue and then on the ground. You hurry up because you can hear the ritual chant getting closer!

Aztec temple
In the future is Mexico City.
 The humming of a ritual chant bounces on the stone walls, you came right on time for the human sacrifice ! It seems like you landed in the past of Latin America and that the great Aztec civilization is at its peak.

A middle sized wall built in a strangely intelligent way with huge stones. It is too big for you to climb..

You can also see an Aztec Statue here.

* * *

>south
Chinese Workshop
In the future is Wuhan.
This workshop is A small and dusty room, with a little window that opens to a wide rice field. The air is tick and gloomy due to the arrival of the rain season. An old artisan wearing a straw hat and loose hemp clothes is making rice paper at the back of the room. You slowly approach the man and, after bending towards in sign of respect, you ask him: - Sir, may I borrow one of these papers please? - Yes, of course, go ahead.

You can see an artisan here.

>south
Maharaja's palace
In the future is the city center of New Delhi.
 The imposing white marble palace is surrounded by the magnificent gardens of prince Abdul the second. Multiple fountains provide fresh water for the animals that reside in the gardens: birds of all colors and sizes that sing from dawn till dusk, little monkeys that jump from tree to tree while attempting to steal whatever you're eating, as welll as magestic and colorful peacocks spreading their feathers into gorgeous fans. While ooking at one of the peacocks, you think to yourself: I bet I could use one of its feathers as a pen...

You can see a Peacock here.

>jump
If you insist.

    *** The End ***

Would you like to RESTART, RESTORE a saved game, QUIT or UNDO the last command?

* * *

>south
Druid's tent
To the south,  you can see a huge marble palace far away. When you look to the north, it seems like there is an ancient building in a hot place.

An old Celtic druid's tent, just like you imagined them. Drapy curtens frame passageways going north and south, they are too thick for you to see threw them. At the very back of the tent, behind all of the mess, you see a back door. Strangely enough, it looks like the one form your office 

The tent is cramped with peculiar shelves. They are made of thick lumber on which rests an army of glass jars filled with colorful liquids. Each jar is labeled with small srips of paper filled with a handwriting you can bearly decipher.

You can also see a small altar (on which are a rounded jar (closed), a skinny jar (closed) and pear shaped jar (closed)) and a cauldron here.

>past
You can't go that way.

>couth
That's not a verb I recognise.

>south
Alexandria's Library
This is probably the greatest sanctuary of knowledge of all time. There are tons of books in there. They don't seem to be arranged in any specific order. You realize just how much looking up stuff was an elephantine task before the Internet.

You can see one hundred Books here.

>future
Savannah
Savannah today

A big and modern glass door. You know, that opaque kind of glass which looks very expensive.

>future
Souk Ruins
A labyrinthine series of corridors unfolds in front of you. The stones that pave the ground reflect the dazzling sunlight

You can see a Chest (closed) here.

>north
Swamps
In south direction you can see something like ruins in the distance. On the opposite direction it seems like there is a temple or a sanctuary.

The air here is breezy. It is hard for you to move comfortably because your feet are plunged in water, or is it silt ? Vegetation is quite dense, reeds and weeds pave your way. If you look west, you can see the framework of a door in the distance. Strangely enough, it looks like the one form your office. There are poorly lit openings in the trees leading either to the north or the south. 

A big and modern glass door. You know, that opaque kind of glass which looks very expensive. This door, however, looks more modern than the ones you have encoutered before, the knob has been replaced by a little blue screen, as if it was meant to be opened with some kind of beeper or pass.

You can also see an Aligator (on which is scaly skin) and a long wooden stick here.

* * *

>open door
The shaking ground gets you out of your reveries. Is it an earthquake ? Is it a bomb ? In any case you hold on to that door knob with all your strength. Too bad, a strong wind sucks you inward before you can gasp for help.  

 Well well, dear player, the dimesions heard you and sent you quite far away. As you just entered a time and space traveling journey you ought to know that taking a strall to the east fast forwards you to the futur, the west brings you back to the past. As for north and south, they will change your location, letting you roam threw different continents.  

One has to be careful with what he wishes for nowadays... Wherever you land, you better find your way back to your meeting, fast, and with the correct supplies.

Scientific Base Camp
Present of Antarctica. In the future, cars a flying and plants living peacefully with humans. The past is white, completely white and frozzen. Don't ask why, but from the south you can here gunshots and a hot breeze caresses your ears. North is hot too, but more primitive.

 The only thing you see beyond the camp's igloos is ice and extracted ice caps. You don't want to spend too much time here unless you always wanted to be a human ice cream. The igloos are scattered over a large area, but one is not far away. If you want to go inside, you'll have to crawl through the tunnel.

You can see a tunnel here.

>go east
You can't go that way.

>go north
Utopian City
Cars finally float on air cushions and plants co-exist with skyscrapers in a friendly and aesthetic way. 

A flying car is floating in front of you.

>go nort
You can't see any such thing.

>go nort
You can't see any such thing.

>go north
Souk Ruins
A labyrinthine series of corridors unfolds in front of you. The stones that pave the ground reflect the dazzling sunlight

You can see a Chest (closed) here.

>go south
Utopian City
Cars finally float on air cushions and plants co-exist with skyscrapers in a friendly and aesthetic way. 

A flying car is floating in front of you.

>go south
Scorpion World
In the past is Mexico City.
Here you step into the future of Latin America. As time passed, a lot of species went extinct. Not scorpions though, scorpions got bigger. Unfortunately, way bigger than you. The whole contient mutated into a huge conurbation of enormous scorpion nests: you are in the middle of it. In front of you is one of those scorpion nest.

>go south
Futuristic Casino
In the past, Wuhan was here. But now, a milion colorful and blinking neon lights iluminate the corridors, and a pathway covered in a fluffy carpet leads you to the Black Jack table. A robot serves you a sparkling drink as the crowd gathered around Black Jack table cheers. You overhear a conversation and it seems like the winner gets a pistol, which could be very useful in opening doors... Since you are here, you might want to try your luck playing the Black Jack. 

You can see a Black Jack table (in which is a pistol) here.

>go west
Wuhan
In the future is a Futuristic Casino and in the past is a Chinese Workshop.
A new, deadly virus was detected for the first time here. The city center is deserted, while the hospitals and morgues are filled with covid patients. You don't have a mask, you not even have a scarf to put around your mouth and nose... 

it might be better for you to leave Wuhan as fast as possible.

You can see a dirty masks here.

>go south
New Delhi
In the future is Yogi's retreat and in the past is Maharaja's palace. You are now in the city center of New Dehli nowadays: your senses are flooded with all kinds of informations. The smells of a thousand spices assault your nostrils from a street market on your right hand and their colors fill up your soul like flowers during spring, birds are singing and market sellers seem to be singing out the prices of their marchandises; the whole thing is wrapped up in a whirlwind of scooters and tuktuks, adding a deeply human touch to the frenzy of the moment.

Somewhere in this exotic atmosphere, your eye catches a strange thing that doesn't seem to belong here: a modern glass door. You know, that opaque kind of glass which looks very expensive. Of course you'd know, your office has the same ones!

>go south
(first opening the modern glass door)
It seems to be locked.

>go south
(first opening the modern glass door)
It seems to be locked.

>go futur
You can't see any such thing.

>go east
Yogi's retreat
In the past is the city center of New Delhi. Now, it is the only community still standing in 20900"s India. This sanctuary is filled with trees, and in the network of streams that run around, you can see huge red, orange and white carps. Yoga matresses are pretty much everywhere, and the smell of the incense is just delightful. You feel a big sense of inner peace... if you stay too long here, you might never leave.

>examine dirty
You can't see any such thing.

>taken dirty
That's not a verb I recognise.

>drop dirty
You can't see any such thing.

>go west
New Delhi
In the future is Yogi's retreat and in the past is Maharaja's palace. You are now in the city center of New Dehli nowadays: your senses are flooded with all kinds of informations. The smells of a thousand spices assault your nostrils from a street market on your right hand and their colors fill up your soul like flowers during spring, birds are singing and market sellers seem to be singing out the prices of their marchandises; the whole thing is wrapped up in a whirlwind of scooters and tuktuks, adding a deeply human touch to the frenzy of the moment.

Somewhere in this exotic atmosphere, your eye catches a strange thing that doesn't seem to belong here: a modern glass door. You know, that opaque kind of glass which looks very expensive. Of course you'd know, your office has the same ones!

>go south
(first opening the modern glass door)
It seems to be locked.

>go north
Wuhan
In the future is a Futuristic Casino and in the past is a Chinese Workshop.
A new, deadly virus was detected for the first time here. The city center is deserted, while the hospitals and morgues are filled with covid patients. You don't have a mask, you not even have a scarf to put around your mouth and nose... 

it might be better for you to leave Wuhan as fast as possible.

You can see a dirty masks here.

>take mask
You can't see any such thing.

>examine mask
You can't see any such thing.

>examine masks
These chirurgical masks have served their purpose already. They now are enjoying their eternal rest.

>take masks
Taken.

>take masks
You already have that.

>drop
(the dirty masks)
Dropped.

>go east
Futuristic Casino
In the past, Wuhan was here. But now, a milion colorful and blinking neon lights iluminate the corridors, and a pathway covered in a fluffy carpet leads you to the Black Jack table. A robot serves you a sparkling drink as the crowd gathered around Black Jack table cheers. You overhear a conversation and it seems like the winner gets a pistol, which could be very useful in opening doors... Since you are here, you might want to try your luck playing the Black Jack. 

You can see a Black Jack table (in which is a pistol) here.

>take pistol
I'll keep my hands off the chinese mafia's stuff if I were you.

>go west
Wuhan
In the future is a Futuristic Casino and in the past is a Chinese Workshop.
A new, deadly virus was detected for the first time here. The city center is deserted, while the hospitals and morgues are filled with covid patients. You don't have a mask, you not even have a scarf to put around your mouth and nose... 

it might be better for you to leave Wuhan as fast as possible.

You can see a dirty masks here.

>take masks
Taken.

>examine masks
These chirurgical masks have served their purpose already. They now are enjoying their eternal rest.

>drop masks
Dropped.

>go east
Futuristic Casino
In the past, Wuhan was here. But now, a milion colorful and blinking neon lights iluminate the corridors, and a pathway covered in a fluffy carpet leads you to the Black Jack table. A robot serves you a sparkling drink as the crowd gathered around Black Jack table cheers. You overhear a conversation and it seems like the winner gets a pistol, which could be very useful in opening doors... Since you are here, you might want to try your luck playing the Black Jack. 

You can see a Black Jack table (in which is a pistol) here.

>play black jack
The cards spins and swirles is spirals of black and red. The man to your left has been here for quite a while, hypnothised by the agility of the card dealer. He layed all his coins on the velvety matt, and has been here long enough to see his gains double and then disapear all together. The last thing he has left to bet is a lazer pistol, and so he bets it. 
 His last glimp of hope leaves his eyes as he watches you flip the winning card and get away with his pistol.

>go south
Yogi's retreat
In the past is the city center of New Delhi. Now, it is the only community still standing in 20900"s India. This sanctuary is filled with trees, and in the network of streams that run around, you can see huge red, orange and white carps. Yoga matresses are pretty much everywhere, and the smell of the incense is just delightful. You feel a big sense of inner peace... if you stay too long here, you might never leave.

>go south
Swamps
The air here is breezy. It is hard for you to move comfortably because your feet are plunged in water, or is it silt ? Vegetation is quite dense, reeds and weeds pave your way. If you look west, you can see the framework of a door in the distance. Strangely enough, it looks like the one form your office. There are poorly lit openings in the trees leading either to the north or the south. 

A big and modern glass door. You know, that opaque kind of glass which looks very expensive. This door, however, looks more modern than the ones you have encoutered before, the knob has been replaced by a little blue screen, as if it was meant to be opened with some kind of beeper or pass.

You can also see an Aligator (on which is scaly skin) and a long wooden stick here.

>go weat
You can't see any such thing.

>go west
(first opening the familiar looking door)
It seems to be locked.

>open door
It seems to be locked.

>unlock door
(with the pistol)
Pfffffff BOOM!! The lazer beem destroys the door and offers you an open pathway towards your beloved office.

office
Somewhere in this exotic atmosphere, your eye catches a strange thing that doesn't seem to belong here: a modern glass door. You know, that opaque kind of glass which looks very expensive. Of course you'd know, your office has the same ones!

A big and modern glass door. You know, that opaque kind of glass which looks very expensive. This door, however, looks more modern than the ones you have encoutered before, the knob has been replaced by a little blue screen, as if it was meant to be opened with some kind of beeper or pass.

A big and modern glass door. You know, that opaque kind of glass which looks very expensive.

You can also see a shiny door here.

Shouldn't you bring back a pen?
Shouldn't you bring back a paper?

* * *

>go north
Please give one of the answers above.

Would you like to RESTART, RESTORE a saved game, QUIT or UNDO the last command?

>go north
Please give one of the answers above.

Would you like to RESTART, RESTORE a saved game, QUIT or UNDO the last command?

>go south
Please give one of the answers above.

Would you like to RESTART, RESTORE a saved game, QUIT or UNDO the last command?

* * *

>go north
Please give one of the answers above.

Would you like to RESTART, RESTORE a saved game, QUIT or UNDO the last command?

>take book
Taken.

>browse book
The book is written in an ancient language you have never seen before. You don't understand anything. Try another one.

>browse book
This looks like ancient Greek. Your are able to decipher a few lines mentioning time travel and a golden key. The next page tells the story of a rich merchant and a chest full of invaluable treasures. On the top of the page, some Arabic numerals indicate the number 1717.

>browse book
The book is written in an ancient language you have never seen before. You don't understand anything. Try another one.

>browse book
There is a Blank Page in the book. You tear it and put it in your pocket.
The book is written in an ancient language you have never seen before. You don't understand anything. Try another one.

>browse book
The book is written in an ancient language you have never seen before. You don't understand anything. Try another one.

* * *

>browse book
This looks like ancient Greek. Your are able to decipher a few lines mentioning time travel and a golden key. The next page tells the story of a rich merchant and a chest full of invaluable treasures. On the top of the page, some Arabic numerals indicate the number 1717.

>browse book
This looks like ancient Greek. Your are able to decipher a few lines mentioning time travel and a golden key. The next page tells the story of a rich merchant and a chest full of invaluable treasures. On the top of the page, some Arabic numerals indicate the number 1717.

* * *

>browse book
The book is written in an ancient language you have never seen before. You don't understand anything. Try another one.

>go east
Savannah
Savannah today

A big and modern glass door. You know, that opaque kind of glass which looks very expensive.

>go east
Souk Ruins
A labyrinthine series of corridors unfolds in front of you. The stones that pave the ground reflect the dazzling sunlight

You can see a Chest (closed) here.

>spin astrolabe to 1212
Click! Nothing happens.

>spin astrolabe to 1717
The Astrolabe produces a symphony of mysterious creaking noises.

>go west
Savannah
Savannah today

A big and modern glass door. You know, that opaque kind of glass which looks very expensive.

>unlock door
What do you want to unlock the shiny door with?

>golden key
You unlock the shiny door.

* * *

>go south
Mexico City
In the future is Scorpion's World and in the past is an Aztec Temple.

Gunshots pierce the sky as you cross the road of today's Mexico. It is getting quite dark and you don't want any trouble, an unharmed guy like you should find a way out of hear. You see four similarly unwellcoming alleyways each leading in different directions: south, north, east and west.

You can see a cartel here.

>go south
Wuhan
In the future is a Futuristic Casino and in the past is a Chinese Workshop.
A new, deadly virus was detected for the first time here. The city center is deserted, while the hospitals and morgues are filled with covid patients. You don't have a mask, you not even have a scarf to put around your mouth and nose... 

it might be better for you to leave Wuhan as fast as possible.

You can see a dirty masks here.

>go south
New Delhi
In the future is Yogi's retreat and in the past is Maharaja's palace. You are now in the city center of New Dehli nowadays: your senses are flooded with all kinds of informations. The smells of a thousand spices assault your nostrils from a street market on your right hand and their colors fill up your soul like flowers during spring, birds are singing and market sellers seem to be singing out the prices of their marchandises; the whole thing is wrapped up in a whirlwind of scooters and tuktuks, adding a deeply human touch to the frenzy of the moment.

Somewhere in this exotic atmosphere, your eye catches a strange thing that doesn't seem to belong here: a modern glass door. You know, that opaque kind of glass which looks very expensive. Of course you'd know, your office has the same ones!

* * *

>go south
(first opening the modern glass door)
It seems to be locked.

>examine ice
You can't see any such thing.

>go east
Yogi's retreat
In the past is the city center of New Delhi. Now, it is the only community still standing in 20900"s India. This sanctuary is filled with trees, and in the network of streams that run around, you can see huge red, orange and white carps. Yoga matresses are pretty much everywhere, and the smell of the incense is just delightful. You feel a big sense of inner peace...

 if you stay here  for too long, you might not find the will to leave.

You can see a relaxing aura here.

>examine aura
You enter a comtemplative state of mind. 

Everything around you resonates in harmony as you crosse you legs and start to levitate. You no longer have any interest in the futilities of human civilisations. You rise above all this now and won't ever go back. 

Let this retreat host your eternal rest.

    *** The End ***

Would you like to RESTART, RESTORE a saved game, QUIT or UNDO the last command?

* * *

>go west
Blizzard
Leave this place, you are in a primitive icy storm. The wind pierces your clothes and shut your eyes closed. You don't want to spend too much time in here. As you are reading this, your toes are getting frozen and threatens to fall. With your office clothes, you don't stand a chance. If you stay here few more seconds, you'll never see your beloved office again.

>go east
Scientific Base Camp
Present of Antarctica. The only thing you see beyond the camp's igloos is ice and extracted ice caps. You don't want to spend too much time here unless you always wanted to be a human ice cream. The igloos are scattered over a large area, but one is not far away. If you want to go inside, you'll have to crawl through the tunnel.

You can see a tunnel here.

>examine cartel
You can't see any such thing.

* * *

>go west
Blizzard
Leave this place, you are in a primitive icy storm. The wind pierces your clothes and shut your eyes closed. You don't want to spend too much time in here. As you are reading this, your toes are getting frozen and threatens to fall. With your office clothes, you don't stand a chance. If you stay here few more seconds, you'll never see your beloved office again.

>go south
Please give one of the answers above.

Would you like to RESTART, RESTORE a saved game, QUIT or UNDO the last command?

>take mask
Please give one of the answers above.

Would you like to RESTART, RESTORE a saved game, QUIT or UNDO the last command?

>take masks
Please give one of the answers above.

Would you like to RESTART, RESTORE a saved game, QUIT or UNDO the last command?

* * *

>s
Chinese Workshop
In the future is Wuhan. In the north - deep in the distance - lays a huge brown and gold temple, could be in South America. If you turn you back to it, you can see another temple which looks more like a sanctuary, asian style.

 This workshop is A small and dusty room, with a little window that opens to a wide rice field. The air is tick and gloomy due to the arrival of the rain season. An old artisan wearing a straw hat and loose hemp clothes is making rice paper at the back of the room. You slowly approach the man and, after bending towards in sign of respect, you ask him: - Sir, may I borrow one of these papers please? - Yes, of course, go ahead.

You can see an artisan here.

>e
Wuhan
In the future is a Futuristic Casino and in the past is a Chinese Workshop.
A new, deadly virus was detected for the first time here. The city center is deserted, while the hospitals and morgues are filled with covid patients. You don't have a mask, you not even have a scarf to put around your mouth and nose... it might be better to leave Wuhan as fast as possible!!

You can see a virus here.

>e
Futuristic Casino
In the past, Wuhan was here. But now, a milion colorful and blinking neon lights iluminate the corridors, and a pathway covered in a fluffy carpet leads you to the Black Jack table. A robot serves you a sparkling drink as the crowd gathered around Black Jack table cheers. You overhear a conversation and it seems like the winner gets a pistol, which could be very useful in opening doors... Since you are here, you might want to try your luck playing the Black Jack. 

You can see a Black Jack table (in which is a pistol) here.

>play black jack
You won the pistol!

* * *

>e
Wuhan
In the future is a Futuristic Casino and in the past is a Chinese Workshop.
A new, deadly virus was detected for the first time here. The city center is deserted, while the hospitals and morgues are filled with covid patients. You don't have a mask, you not even have a scarf to put around your mouth and nose... it might be better to leave Wuhan as fast as possible!!

You can see a virus here.

>s
New Delhi
In the future is Yogi's retreat and in the past is Maharaja's palace. You are now in the city center of New Dehli nowadays: your senses are flooded with all kinds of informations. The smells of a thousand spices assault your nostrils from a street market on your right hand and their colors fill up your soul like flowers in the spring, birds are singing and market sellers seems to be answering them prices of their marchandises; the whole thing is wrapped up in a whirlwind of scooters and tuktuk, adding a deeply human touch to the frenzy of the moment.

Somewhere in this exotic atmosphere, your eye catches a strange thing that doesn't seem to belong here: a modern glass door. You know, that opaque kind of glass which looks very expensive. Of course you'd know, your office has the same ones.

>s
(first opening the modern glass door)
It seems to be locked.

>n
Wuhan
In the future is a Futuristic Casino and in the past is a Chinese Workshop.
A new, deadly virus was detected for the first time here. The city center is deserted, while the hospitals and morgues are filled with covid patients. You don't have a mask, you not even have a scarf to put around your mouth and nose... it might be better to leave Wuhan as fast as possible!!

You can see a virus here.

>e
Futuristic Casino
In the past, Wuhan was here. But now, a milion colorful and blinking neon lights iluminate the corridors, and a pathway covered in a fluffy carpet leads you to the Black Jack table. A robot serves you a sparkling drink as the crowd gathered around Black Jack table cheers. You overhear a conversation and it seems like the winner gets a pistol, which could be very useful in opening doors... Since you are here, you might want to try your luck playing the Black Jack. 

You can see a Black Jack table (in which is a pistol) here.

* * *

>play black jack
You won the pistol!

>e
You can't go that way.

>w
Wuhan
In the future is a Futuristic Casino and in the past is a Chinese Workshop.
A new, deadly virus was detected for the first time here. The city center is deserted, while the hospitals and morgues are filled with covid patients. You don't have a mask, you not even have a scarf to put around your mouth and nose... it might be better to leave Wuhan as fast as possible!!

You can see a virus here.

>s
New Delhi
In the future is Yogi's retreat and in the past is Maharaja's palace. You are now in the city center of New Dehli nowadays: your senses are flooded with all kinds of informations. The smells of a thousand spices assault your nostrils from a street market on your right hand and their colors fill up your soul like flowers in the spring, birds are singing and market sellers seems to be answering them prices of their marchandises; the whole thing is wrapped up in a whirlwind of scooters and tuktuk, adding a deeply human touch to the frenzy of the moment.

Somewhere in this exotic atmosphere, your eye catches a strange thing that doesn't seem to belong here: a modern glass door. You know, that opaque kind of glass which looks very expensive. Of course you'd know, your office has the same ones.

* * *

>s
(first opening the modern glass door)
It seems to be locked.

>unlock the door with the pistol
Pfffffff boom!! And the bullet destroys the door.

>s
That's not a verb I recognise.

>s
(first opening the modern glass door)
It seems to be locked.

* * *

>play black jack
You won the pistol!

* * *

>s
(first opening the modern glass door)
It seems to be locked.

>unlock door with pistol
Pfffffff BOOM!! The bullet destroys the door, and now you can go back to the office
office
- No paper, no pens, is this really it? The office of the future?

Now out of your Leather chair, you take a last look at the conference table. You think to yourself:

It can't be. All it is, is a realm of shiny metals and cold greatings. Your buzzing laptop the stainless glass door, the cold coffee you drink, everything you lay your eyes on is chilling.

Going for a strawl could be exactly what you need. Suddenly, you catch yourself hoping for a paper shortage in the whole damn building or, better even, in the whole damn town. So you'd have an excuse to put some miles between you and this place.

* * *

>s
Wuhan
In the future is a Futuristic Casino and in the past is a Chinese Workshop.
A new, deadly virus was detected for the first time here. The city center is deserted, while the hospitals and morgues are filled with covid patients. You don't have a mask, you not even have a scarf to put around your mouth and nose... it might be better to leave Wuhan as fast as possible!!

You can see a virus here.

>e
New Delhi
In the future is Yogi's retreat and in the past is Maharaja's palace. You are now in the city center of New Dehli nowadays: your senses are flooded with all kinds of informations. The smells of a thousand spices assault your nostrils from a street market on your right hand and their colors fill up your soul like flowers in the spring, birds are singing and market sellers seems to be answering them prices of their marchandises; the whole thing is wrapped up in a whirlwind of scooters and tuktuk, adding a deeply human touch to the frenzy of the moment.

Somewhere in this exotic atmosphere, your eye catches a strange thing that doesn't seem to belong here: a modern glass door. You know, that opaque kind of glass which looks very expensive. Of course you'd know, your office has the same ones.

>w
Maharaja's palace
In the future is the city center of New Delhi. The imposing white marble palace is surrounded by the magnificent gardens of prince Abdul the second. Multiple fountains provide fresh water for the animals that reside in the gardens: birds of all colors and sizes that sing from dawn till dusk, little monkeys that jump from tree to tree and try to steal whatever you're eating, and beautiful colorful peacocks that turn around. Looking one of the peacocks, you think to yourself: I bet I could use one of its feathers as a pen...

You can see a Peacock here.

>n
Chinese Workshop
In the future is Wuhan.
This workshop is A small and dusty room, with a little window that opens to a wide rice field. The air is tick and gloomy due to the arrival of the rain season. An old artisan wearing a straw hat and loose hemp clothes made is making rice paper at the back of the room. You slowly approach the man and, after bending towards in sign of respect, you ask him: - Sir, may I borrow one of these please? - Yes, of course, go ahead.

You can see an artisan here.

>w
You can't go that way.

>e
Wuhan
In the future is a Futuristic Casino and in the past is a Chinese Workshop.
A new, deadly virus was detected for the first time here. The city center is deserted, while the hospitals and morgues are filled with covid patients. You don't have a mask, you not even have a scarf to put around your mouth and nose... it might be better to leave Wuhan as fast as possible!!

You can see a virus here.

>e
Futuristic Casino
In the past, Wuhan was here. But now, a milion colorful and blinking neon lights iluminate the corridors, and a pathway covered in a fluffy carpet leads you to the Black Jack table. A robot serves you a sparkling drink as the crowd gathered around Black Jack table cheers. You overhear a conversation, and it seems like the prize is a pistol, which could be very useful in opening doors... Since you are here, you might want to try your luck playing the Black Jack. 

You can see a Black Jack table (in which is a pistol) here.

* * *

>s
Wuhan
In the future is a Futuristic Casino and in the past is a Chinese Workshop.
A new, deadly virus was detected for the first time here. The city center is deserted, while the hospitals and morgues are filled with covid patients. You don't have a mask, you not even have a scarf to put around your mouth and nose... it might be better to leave Wuhan as fast as possible!!

You can see a virus here.

>w
Chinese Workshop
In the future is Wuhan.
This workshop is A small and dusty room, with a little window that opens to a wide rice field. The air is tick and gloomy due to the arrival of the rain season. An old artisan wearing a straw hat and loose hemp clothes made is making rice paper at the back of the room. You slowly approach the man and, after bending towards in sign of respect, you ask him: - Sir, may I borrow one of these papers please? - Yes, of course, go ahead.

You can see an artisan here.

>e
Wuhan
In the future is a Futuristic Casino and in the past is a Chinese Workshop.
A new, deadly virus was detected for the first time here. The city center is deserted, while the hospitals and morgues are filled with covid patients. You don't have a mask, you not even have a scarf to put around your mouth and nose... it might be better to leave Wuhan as fast as possible!!

You can see a virus here.

* * *

>play black jack
You won the pistol!

>w
Wuhan
In the future is a Futuristic Casino and in the past is a Chinese Workshop.
A new, deadly virus was detected for the first time here. The city center is deserted, while the hospitals and morgues are filled with covid patients. You don't have a mask, you not even have a scarf to put around your mouth and nose... it might be better to leave Wuhan as fast as possible!!

You can see a virus here.

* * *

>s
(first opening the modern glass door)
It seems to be locked.

>open door
It seems to be locked.

>unlock door
(with the pistol)
Pfffffff boom!! And the bullet destroys the door.

office
- No paper, no pens, is this really it? The office of the future?

Now out of your Leather chair, you take a last look at the conference table. You think to yourself:

It can't be. All it is, is a realm of shiny metals and cold greatings. Your buzzing laptop the stainless glass door, the cold coffee you drink, everything you lay your eyes on is chilling.

Going for a strawl could be exactly what you need. Suddenly, you catch yourself hoping for a paper shortage in the whole damn building or, better even, in the whole damn town. So you'd have an excuse to put some miles between you and this place.

* * *

>s
(first opening the modern glass door)
It seems to be locked.

>unlock door
(with the pistol)
Pfffffff BOOM!! The bullet destroys the door, and now you can go back to the office

>s
(first opening the modern glass door)
It seems to be locked.

* * *

>e
Wuhan
In the future is a Futuristic Casino and in the past is a Chinese Workshop.
A new, deadly virus was detected for the first time here. The city center is deserted, while the hospitals and morgues are filled with covid patients. You don't have a mask, you not even have a scarf to put around your mouth and nose... it might be better to leave Wuhan as fast as possible!!

You can see a virus here.

>s
(first opening the modern glass door)
It seems to be locked.

* * *

>n
Wuhan
In the future is a Futuristic Casino and in the past is a Chinese Workshop.
A new, deadly virus was detected for the first time here. The city center is deserted, while the hospitals and morgues are filled with covid patients. You don't have a mask, you not even have a scarf to put around your mouth and nose... it might be better to leave Wuhan as fast as possible!!

You can see a virus here.

>w
Chinese Workshop
In the future is Wuhan.
This workshop is A small and dusty room, with a little window that opens to a wide rice field. The air is tick and gloomy due to the arrival of the rain season. An old artisan wearing a straw hat and loose hemp clothes made is making rice paper at the back of the room. You slowly approach the man and, after bending towards in sign of respect, you ask him: - Sir, may I borrow one of these please? - Yes, of course, go ahead.

You can see an artisan here.

>e
Wuhan
In the future is a Futuristic Casino and in the past is a Chinese Workshop.
A new, deadly virus was detected for the first time here. The city center is deserted, while the hospitals and morgues are filled with covid patients. You don't have a mask, you not even have a scarf to put around your mouth and nose... it might be better to leave Wuhan as fast as possible!!

You can see a virus here.

* * *

>s
(first opening the modern glass door)
It seems to be locked.

>unlock door with pistol
You unlock the modern glass door.

>s
(first opening the modern glass door)

office
- No paper, no pens, is this really it? The office of the future?

Now out of your Leather chair, you take a last look at the conference table. You think to yourself:

It can't be. All it is, is a realm of shiny metals and cold greatings. Your buzzing laptop the stainless glass door, the cold coffee you drink, everything you lay your eyes on is chilling.

Going for a strawl could be exactly what you need. Suddenly, you catch yourself hoping for a paper shortage in the whole damn building or, better even, in the whole damn town. So you'd have an excuse to put some miles between you and this place.

* * *

>w
Chinese Workshop
In the future is Wuhan.
This workshop is A small and dusty room, with a little window that opens to a wide rice field. The air is tick and gloomy due to the arrival of the rain season. An old artisan wearing a straw hat and loose hemp clothes made is making rice paper at the back of the room. You slowly approach the man and, after bending towards in sign of respect, you ask him: - Sir, may I borrow one of these papers please? - Yes, of course, go ahead.

You can see an artisan here.

>s
New Delhi
In the future is Yogi's retreat and in the past is Maharaja's palace. You are now in the city center of New Dehli nowadays: your senses are flooded with all kinds of informations. The smells of a thousand spices assault your nostrils from a street market on your right hand and their colors fill up your soul like flowers in the spring, birds are singing and market sellers seems to be answering them prices of their marchandises; the whole thing is wrapped up in a whirlwind of scooters and tuktuk, adding a deeply human touch to the frenzy of the moment.

Somewhere in this exotic atmosphere, your eye catches a strange thing that doesn't seem to belong here: a modern glass door. You know, that opaque kind of glass which looks very expensive. Of course you'd know, your office has the same ones.

>s
(first opening the modern glass door)
 Wouldn't it be better to go back with everything your boss has asked for? You still don't have a pen

>s
(first opening the modern glass door)
 Wouldn't it be better to go back with everything your boss has asked for? You still don't have a pen

>open the door
 Wouldn't it be better to go back with everything your boss has asked for? You still don't have a pen

* * *

>take paper
You thank the old man for the paper and now you go look for the pen in order to go back to the office.

>w
You can't go that way.

>e
Wuhan
In the future is a Futuristic Casino and in the past is a Chinese Workshop. To the north is a huge modern city and in the opposite direction is filled whit colors, sounds and human interaction.

A new, deadly virus was detected for the first time here. The city center is deserted, while the hospitals and morgues are filled with covid patients. You don't have a mask, you not even have a scarf to put around your mouth and nose... 

it might be better for you to leave Wuhan as fast as possible.

You can see a dirty masks here.

>e
Futuristic Casino
In the past, Wuhan was here. You can't be sure, but in the north you might be seeing what looks like weird huge dinosaurs; nothing surprises you anymore... Not even the sanctuary that is in the opposite direction.

 But now, a milion colorful and blinking neon lights iluminate the corridors, and a pathway covered in a fluffy carpet leads you to the Black Jack table. A robot serves you a sparkling drink as the crowd gathered around Black Jack table cheers. You overhear a conversation and it seems like the winner gets a pistol, which could be very useful in opening doors... Since you are here, you might want to try your luck playing the Black Jack. 

You can see a Black Jack table (in which is a pistol) here.

>play black jack
The cards spins and swirles is spirals of black and red. The man to your left has been here for quite a while, hypnothised by the agility of the card dealer. He layed all his coins on the velvety matt, and has been here long enough to see his gains double and then disapear all together. The last thing he has left to bet is a lazer pistol, and so he bets it. 
 His last glimp of hope leaves his eyes as he watches you flip the winning card and get away with his pistol.

>w
Wuhan
In the future is a Futuristic Casino and in the past is a Chinese Workshop. To the north is a huge modern city and in the opposite direction is filled whit colors, sounds and human interaction.

A new, deadly virus was detected for the first time here. The city center is deserted, while the hospitals and morgues are filled with covid patients. You don't have a mask, you not even have a scarf to put around your mouth and nose... 

it might be better for you to leave Wuhan as fast as possible.

You can see a dirty masks here.

>s
New Delhi
In the future is Yogi's retreat and in the past is Maharaja's palace. To the north is a huge modern city.

 You are now in the city center of New Dehli nowadays: your senses are flooded with all kinds of informations. The smells of a thousand spices assault your nostrils from a street market on your right hand and their colors fill up your soul like flowers during spring, birds are singing and market sellers seem to be singing out the prices of their marchandises; the whole thing is wrapped up in a whirlwind of scooters and tuktuks, adding a deeply human touch to the frenzy of the moment.

Somewhere in this exotic atmosphere, your eye catches a strange thing that doesn't seem to belong here: a modern glass door. You know, that opaque kind of glass which looks very expensive. Of course you'd know, your office has the same ones!

>unlock door with pistol
Pfffffff BOOM!! The lazer beem destroys the door and offers you an open pathway towards your beloved office.

office
Somewhere in this exotic atmosphere, your eye catches a strange thing that doesn't seem to belong here: a modern glass door. You know, that opaque kind of glass which looks very expensive. Of course you'd know, your office has the same ones!

A big and modern glass door. You know, that opaque kind of glass which looks very expensive.

A big and modern glass door. You know, that opaque kind of glass which looks very expensive. This door, however, looks more modern than the ones you have encoutered before, the knob has been replaced by a little blue screen, as if it was meant to be opened with some kind of beeper or pass.

You can also see a shiny door here.

Shouldn't you bring back a pen?
You got the paper, but with what are the people supposed to sign with?

* * *

>w
You can't go that way.

* * *

>e
Futuristic Casino
In the past, Wuhan was here. But now, a milion colorful and blinking neon lights iluminate the corridors, and a pathway covered in a fluffy carpet leads you to the Black Jack table. A robot serves you a sparkling drink as the crowd gathered around Black Jack table cheers. You overhear a conversation and it seems like the winner gets a pistol, which could be very useful in opening doors... Since you are here, you might want to try your luck playing the Black Jack. 

You can see a Black Jack table (in which is a pistol) here.

>black jack
Please give one of the answers above.

Would you like to RESTART, RESTORE a saved game, QUIT or UNDO the last command?

>x black jack
Please give one of the answers above.

Would you like to RESTART, RESTORE a saved game, QUIT or UNDO the last command?

>undo
The office
[Previous turn undone.]

>open door
The shaking ground gets you out of your reveries. Is it an earthquake ? Is it a bomb ? In any case you hold on to that door knob with all your strength. Too bad, a strong wind sucks you inward before you can gasp for help.  

 Well well, dear player, the dimesions heard you and sent you quite far away. As you just entered a time and space traveling journey you ought to know that taking a strall to the east fast forwards you to the futur, the west brings you back to the past. As for north and south, they will change your location, letting you roam threw different continents.  

One has to be careful with what he wishes for nowadays... Wherever you land, you better find your way back to your meeting, fast, and with the correct supplies.

Aztec temple
In the future is Mexico City.
 The humming of a ritual chant bounces on the stone walls, you came right on time for the human sacrifice ! It seems like you landed in the past of Latin America and that the great Aztec civilization is at its peak.

A middle sized wall built in a strangely intelligent way with huge stones. It is too big for you to climb..

You can also see an Aztec Statue here.

>s
Chinese Workshop
In the future is Wuhan.
This workshop is A small and dusty room, with a little window that opens to a wide rice field. The air is tick and gloomy due to the arrival of the rain season. An old artisan wearing a straw hat and loose hemp clothes made is making rice paper at the back of the room. You slowly approach the man and, after bending towards in sign of respect, you ask him: - Sir, may I borrow one of these please? - Yes, of course, go ahead.

You can see an artisan here.

>w
You can't go that way.

* * *

>e
Wuhan
In the future is a Futuristic Casino and in the past is a Chinese Workshop.
A new, deadly virus was detected for the first time here. The city center is deserted, while the hospitals and morgues are filled with covid patients. You don't have a mask, you not even have a scarf to put around your mouth and nose... it might be better to leave Wuhan as fast as possible!!

You can see a virus here.

>e
Futuristic Casino
In the past, Wuhan was here. But now, a milion colorful and blinking neon lights iluminate the corridors, and a pathway covered in a fluffy carpet leads you to the Black Jack table. A robot serves you a sparkling drink as the crowd gathered around Black Jack table cheers.

You can see a Black Jack (in which is a hidden pistol) here.

>play black jack
You won the pistol!

>x black jack
In the Black Jack is a hidden pistol.

* * *

>w
Wuhan
In the future is a Futuristic Casino and in the past is a Chinese Workshop.
A new, deadly virus was detected for the first time here. The city center is deserted, while the hospitals and morgues are filled with covid patients. You don't have a mask, you not even have a scarf to put around your mouth and nose... it might be better to leave Wuhan as fast as possible!!

You can see a virus here.

>w
Chinese Workshop
In the future is Wuhan.
This workshop is A small and dusty room, with a little window that opens to a wide rice field. The air is tick and gloomy due to the arrival of the rain season. An old artisan wearing a straw hat and loose hemp clothes made is making rice paper at the back of the room. You slowly approach the man and, after bending towards in sign of respect, you ask him: - Sir, may I borrow one of these papers please? - Yes, of course, go ahead.

You can see an artisan here.

>take paper
You thank the old man for the paper and now you go look for the pen in order to go back to the office.

>e
Wuhan
In the future is a Futuristic Casino and in the past is a Chinese Workshop.
A new, deadly virus was detected for the first time here. The city center is deserted, while the hospitals and morgues are filled with covid patients. You don't have a mask, you not even have a scarf to put around your mouth and nose... it might be better to leave Wuhan as fast as possible!!

You can see a virus here.

* * *

>s
(first opening the modern glass door)
It seems to be locked.

>unlock door
What do you want to unlock the modern glass door with?

>with the pistol
You can't see any such thing.

>i
You are carrying:
  Paper rice
  a pistol

>unlock door with pistol
Pfffffff BOOM!! The bullet destroys the door, and now you can go back to the office.

office
- No paper, no pens, is this really it? The office of the future?

Now out of your Leather chair, you take a last look at the conference table. You think to yourself:

It can't be. All it is, is a realm of shiny metals and cold greatings. Your buzzing laptop the stainless glass door, the cold coffee you drink, everything you lay your eyes on is chilling.

Going for a strawl could be exactly what you need. Suddenly, you catch yourself hoping for a paper shortage in the whole damn building or, better even, in the whole damn town. So you'd have an excuse to put some miles between you and this place.

Shouldn't you bring back a pen?
You got the paper, but with what are the people supposed to sign with?

* * *

>take tale
You can't see any such thing.

>i
You are carrying nothing.

>x
(the tunnel)
You see nothing special about the tunnel.

>touch baby scorpion
You can't see any such thing.

>take tale
You can't see any such thing.

>touch baby scorpion
You can't see any such thing.

>touch
(the tunnel)
You feel nothing unexpected.

>attack baby scorpion
You can't see any such thing.

>s
Mexico City
In the future is Scorpion's World and in the past is an Aztec Temple. If you look up north, all is frozen in the distance when in south everything seems be made of steal and concrete.

 Gunshots pierce the sky as you cross the road of today's Mexico. It is getting quite dark and you don't want any trouble, an unharmed guy like you should find a way out of hear. You see four similarly unwellcoming alleyways each leading in different directions: south, north, east and west.

You can see a cartel here.

>play black jack
You can't see any such thing.

>i
Oh no. 

Two fighting cartels stumbled onto you, didn't knowing were you stand, the leaders of both cartels shot you to prove their guts to each other.They left you no tim time to escape.

Let Mexico city be your final destination.

    *** The End ***

Would you like to RESTART, RESTORE a saved game, QUIT or UNDO the last command?

>w
Please give one of the answers above.

Would you like to RESTART, RESTORE a saved game, QUIT or UNDO the last command?

>e
Please give one of the answers above.

Would you like to RESTART, RESTORE a saved game, QUIT or UNDO the last command?

>e
Please give one of the answers above.

Would you like to RESTART, RESTORE a saved game, QUIT or UNDO the last command?

>w
Please give one of the answers above.

Would you like to RESTART, RESTORE a saved game, QUIT or UNDO the last command?

>w
Please give one of the answers above.

Would you like to RESTART, RESTORE a saved game, QUIT or UNDO the last command?

>tale paper
Please give one of the answers above.

Would you like to RESTART, RESTORE a saved game, QUIT or UNDO the last command?

>take paper
Please give one of the answers above.

Would you like to RESTART, RESTORE a saved game, QUIT or UNDO the last command?

>e
Please give one of the answers above.

Would you like to RESTART, RESTORE a saved game, QUIT or UNDO the last command?

>s
Please give one of the answers above.

Would you like to RESTART, RESTORE a saved game, QUIT or UNDO the last command?

>open door
Please give one of the answers above.

Would you like to RESTART, RESTORE a saved game, QUIT or UNDO the last command?

>use pistol to open door
Please give one of the answers above.

Would you like to RESTART, RESTORE a saved game, QUIT or UNDO the last command?

>unlock door with pistol
Please give one of the answers above.

Would you like to RESTART, RESTORE a saved game, QUIT or UNDO the last command?

* * *

>undo
The office
[Previous turn undone.]

>open doo
You can't see any such thing.

>open door
The shaking ground gets you out of your reveries. Is it an earthquake ? Is it a bomb ? In any case you hold on to that door knob with all your strength. Too bad, a strong wind sucks you inward before you can gasp for help.  

 Well well, dear player, the dimesions heard you and sent you quite far away. As you just entered a time and space traveling journey you ought to know that taking a strall to the east fast forwards you to the futur, the west brings you back to the past. As for north and south, they will change your location, letting you roam threw different continents.  

One has to be careful with what he wishes for nowadays... Wherever you land, you better find your way back to your meeting, fast, and with the correct supplies.

Aztec temple
In the future is Mexico City.
The humming of a ritual chant bounces on the stone walls, you came right on time for the human sacrifice ! It seems like you landed in the past of Latin America and that the great Aztec civilization is at its peak.

A middle sized wall built in a strangely intelligent way with huge stones. It is too big for you to climb..

You can also see an Aztec Statue here.

>s
Chinese Workshop
In the future is Wuhan. In the north - deep in the distance - lays a huge brown and gold temple, could be in South America. If you turn you back to it, you can see another temple which looks more like a sanctuary, asian style.

 This workshop is A small and dusty room, with a little window that opens to a wide rice field. The air is tick and gloomy due to the arrival of the rain season. An old artisan wearing a straw hat and loose hemp clothes is making rice paper at the back of the room. You slowly approach the man and, after bending towards in sign of respect, you ask him: - Sir, may I borrow one of these papers please? - Yes, of course, go ahead.

You can see an artisan here.

>s
Maharaja's palace
In the future is the city center of New Delhi. From what you can see, south seems like a place in north europa when north looks more chinese. It is definitely difficult to understand the geography of this strange world. 

 The imposing white marble palace is surrounded by the magnificent gardens of prince Abdul the second. Multiple fountains provide fresh water for the animals that reside in the gardens: birds of all colors and sizes that sing from dawn till dusk, little monkeys that jump from tree to tree while attempting to steal whatever you're eating, as welll as magestic and colorful peacocks spreading their feathers into gorgeous fans. While ooking at one of the peacocks, you think to yourself: I bet I could use one of its feathers as a pen...

You can see a Peacock here.

>w
You can't go that way.

>e
New Delhi
In the future is Yogi's retreat and in the past is Maharaja's palace. To the north is a huge modern city.

 You are now in the city center of New Dehli nowadays: your senses are flooded with all kinds of informations. The smells of a thousand spices assault your nostrils from a street market on your right hand and their colors fill up your soul like flowers during spring, birds are singing and market sellers seem to be singing out the prices of their marchandises; the whole thing is wrapped up in a whirlwind of scooters and tuktuks, adding a deeply human touch to the frenzy of the moment.

Somewhere in this exotic atmosphere, your eye catches a strange thing that doesn't seem to belong here: a modern glass door. You know, that opaque kind of glass which looks very expensive. Of course you'd know, your office has the same ones!

>open door
Shouldn't you bring back a pen?
Shouldn't you bring back a paper?

It seems to be locked.

* * *

>undo
The office
[Previous turn undone.]

>open door
The shaking ground gets you out of your reveries. Is it an earthquake ? Is it a bomb ? In any case you hold on to that door knob with all your strength. Too bad, a strong wind sucks you inward before you can gasp for help.  

 Well well, dear player, the dimesions heard you and sent you quite far away. As you just entered a time and space traveling journey you ought to know that taking a strall to the east fast forwards you to the futur, the west brings you back to the past. As for north and south, they will change your location, letting you roam threw different continents.  

One has to be careful with what he wishes for nowadays... Wherever you land, you better find your way back to your meeting, fast, and with the correct supplies.

Scorpion World
In the past is Mexico City. North and south seems to be far in the future; the first one is animated by iron and glass things flying through blue skies ans the second is filled with light and cashmachine sounds.

 Here you step into the future of Latin America. As time passed, a lot of species went extinct. Not scorpions though, scorpions got bigger. Unfortunately, way bigger than you. The whole contient mutated into a huge conurbation of enormous scorpion nests: you are in the middle of it. In front of you is one of those scorpion nest.

>s
Futuristic Casino
In the past, Wuhan was here. You can't be sure, but in the north you might be seeing what looks like weird huge dinosaurs; nothing surprises you anymore... Not even the sanctuary that is in the opposite direction.

 But now, a milion colorful and blinking neon lights iluminate the corridors, and a pathway covered in a fluffy carpet leads you to the Black Jack table. A robot serves you a sparkling drink as the crowd gathered around Black Jack table cheers. You overhear a conversation and it seems like the winner gets a pistol, which could be very useful in opening doors... Since you are here, you might want to try your luck playing the Black Jack. 

You can see a Black Jack table (in which is a pistol) here.

>play black jack
The cards spins and swirles is spirals of black and red. The man to your left has been here for quite a while, hypnothised by the agility of the card dealer. He layed all his coins on the velvety matt, and has been here long enough to see his gains double and then disapear all together. The last thing he has left to bet is a lazer pistol, and so he bets it. 
 His last glimp of hope leaves his eyes as he watches you flip the winning card and get away with his pistol.

* * *

>w
Wuhan
In the future is a Futuristic Casino and in the past is a Chinese Workshop. To the north is a huge modern city and in the opposite direction is filled whit colors, sounds and human interaction.

A new, deadly virus was detected for the first time here. The city center is deserted, while the hospitals and morgues are filled with covid patients. You don't have a mask, you not even have a scarf to put around your mouth and nose... 

it might be better for you to leave Wuhan as fast as possible.

You can see a dirty masks here.

>w
Chinese Workshop
In the future is Wuhan. In the north - deep in the distance - lays a huge brown and gold temple, could be in South America. If you turn you back to it, you can see another temple which looks more like a sanctuary, asian style.

 This workshop is A small and dusty room, with a little window that opens to a wide rice field. The air is tick and gloomy due to the arrival of the rain season. An old artisan wearing a straw hat and loose hemp clothes is making rice paper at the back of the room. You slowly approach the man and, after bending towards in sign of respect, you ask him: - Sir, may I borrow one of these papers please? - Yes, of course, go ahead.

You can see an artisan here.

>take paper
You thank the old man for the paper and now you go look for the pen in order to go back to the office.

>e
Wuhan
In the future is a Futuristic Casino and in the past is a Chinese Workshop. To the north is a huge modern city and in the opposite direction is filled whit colors, sounds and human interaction.

A new, deadly virus was detected for the first time here. The city center is deserted, while the hospitals and morgues are filled with covid patients. You don't have a mask, you not even have a scarf to put around your mouth and nose... 

it might be better for you to leave Wuhan as fast as possible.

You can see a dirty masks here.

>s
New Delhi
In the future is Yogi's retreat and in the past is Maharaja's palace. To the north is a huge modern city.

 You are now in the city center of New Dehli nowadays: your senses are flooded with all kinds of informations. The smells of a thousand spices assault your nostrils from a street market on your right hand and their colors fill up your soul like flowers during spring, birds are singing and market sellers seem to be singing out the prices of their marchandises; the whole thing is wrapped up in a whirlwind of scooters and tuktuks, adding a deeply human touch to the frenzy of the moment.

Somewhere in this exotic atmosphere, your eye catches a strange thing that doesn't seem to belong here: a modern glass door. You know, that opaque kind of glass which looks very expensive. Of course you'd know, your office has the same ones!

>unlock door with pistol
Pfffffff BOOM!! The lazer beem destroys the door and offers you an open pathway towards your beloved office.

office
Somewhere in this exotic atmosphere, your eye catches a strange thing that doesn't seem to belong here: a modern glass door. You know, that opaque kind of glass which looks very expensive. Of course you'd know, your office has the same ones!

A big and modern glass door. You know, that opaque kind of glass which looks very expensive.

A big and modern glass door. You know, that opaque kind of glass which looks very expensive. This door, however, looks more modern than the ones you have encoutered before, the knob has been replaced by a little blue screen, as if it was meant to be opened with some kind of beeper or pass.

You can also see a shiny door here.

Shouldn't you bring back a paper and a pen?
Shouldn't you bring back a pen?
You got the paper, but with what are the people supposed to sign with?

* * *

>s
Wuhan
In the future is a Futuristic Casino and in the past is a Chinese Workshop.
A new, deadly virus was detected for the first time here. The city center is deserted, while the hospitals and morgues are filled with covid patients. You don't have a mask, you not even have a scarf to put around your mouth and nose... it might be better to leave Wuhan as fast as possible!!

You can see a virus here.

>e
Futuristic Casino
In the past, Wuhan was here. But now, a milion colorful and blinking neon lights iluminate the corridors, and a pathway covered in a fluffy carpet leads you to the Black Jack table. A robot serves you a sparkling drink as the crowd gathered around Black Jack table cheers. You overhear a conversation and it seems like the winner gets a pistol, which could be very useful in opening doors... Since you are here, you might want to try your luck playing the Black Jack. 

You can see a Black Jack table (in which is a pistol) here.

* * *

>s
(first opening the modern glass door)
It seems to be locked.

>unlock door
(with the pistol)
Pfffffff BOOM!! The bullet destroys the door, and now you can go back to the office.

office
- No paper, no pens, is this really it? The office of the future?

Now out of your Leather chair, you take a last look at the conference table. You think to yourself:

It can't be. All it is, is a realm of shiny metals and cold greatings. Your buzzing laptop the stainless glass door, the cold coffee you drink, everything you lay your eyes on is chilling.

Going for a strawl could be exactly what you need. Suddenly, you catch yourself hoping for a paper shortage in the whole damn building or, better even, in the whole damn town. So you'd have an excuse to put some miles between you and this place.

Shouldn't you bring back a pen?
Shouldn't you bring back a paper?

* * *

>restart
Are you sure you want to restart?

Please answer yes or no.

* * *

>open door
The shaking ground gets you out of your reveries. Is it an earthquake ? Is it a bomb ? In any case you hold on to that door knob with all your strength. Too bad, a strong wind sucks you inward before you can gasp for help.  

 Well well, dear player, the dimesions heard you and sent you quite far away. As you just entered a time and space traveling journey you ought to know that taking a strall to the east fast forwards you to the futur, the west brings you back to the past. As for north and south, they will change your location, letting you roam threw different continents.  

One has to be careful with what he wishes for nowadays... Wherever you land, you better find your way back to your meeting, fast, and with the correct supplies.

If you insist. 

Many people died on the battlefield against the coronavirus. 

First to be hit were the people of Wuhan.

You were one of them.

    *** The End ***

Would you like to RESTART, RESTORE a saved game, QUIT or UNDO the last command?

>go west
Please give one of the answers above.

Would you like to RESTART, RESTORE a saved game, QUIT or UNDO the last command?

>go east
Please give one of the answers above.

Would you like to RESTART, RESTORE a saved game, QUIT or UNDO the last command?

>go west
Please give one of the answers above.

Would you like to RESTART, RESTORE a saved game, QUIT or UNDO the last command?

>hello
Please give one of the answers above.

Would you like to RESTART, RESTORE a saved game, QUIT or UNDO the last command?

>go west
Please give one of the answers above.

Would you like to RESTART, RESTORE a saved game, QUIT or UNDO the last command?